,DATE,REGION,NEW_CASES,CUMULATIVE_CASES,NEW_DEATHS,CUMULATIVE_DEATHS,NEW_FIRST_DOSES,CUMULATIVE_FIRST_DOSES,NEW_SECOND_DOSES,CUMULATIVE_SECOND_DOSES,CUMULATIVE_RECOVERED,NEW_RECOVERED,ACTIVE_CASES
0,2020-03-26,São Paulo,0,565,0,50,0,0,0,0,0,0,515
1,2020-03-27,São Paulo,0,565,0,50,0,0,0,0,0,0,515
2,2020-03-28,São Paulo,0,565,13,63,0,0,0,0,0,0,502
3,2020-03-29,São Paulo,0,565,13,76,0,0,0,0,0,0,489
4,2020-03-30,São Paulo,28,593,24,100,0,0,0,0,0,0,493
5,2020-03-31,São Paulo,845,1438,18,118,0,0,0,0,0,0,1320
6,2020-04-01,São Paulo,65,1503,23,141,0,0,0,0,0,0,1362
7,2020-04-02,São Paulo,17,1520,24,165,0,0,0,0,0,0,1355
8,2020-04-03,São Paulo,801,2321,48,213,0,0,0,0,0,0,2108
9,2020-04-04,São Paulo,408,2729,0,213,0,0,0,0,0,0,2516
10,2020-04-05,São Paulo,883,3612,6,219,0,0,0,0,0,0,3393
11,2020-04-06,São Paulo,142,3754,25,244,0,0,0,0,0,0,3510
12,2020-04-07,São Paulo,749,4503,53,297,0,0,0,0,0,0,4206
13,2020-04-08,São Paulo,634,5137,44,341,0,0,0,0,0,0,4796
14,2020-04-09,São Paulo,695,5832,45,386,0,0,0,0,5491,5491,-45
15,2020-04-10,São Paulo,547,6379,26,412,0,0,0,0,5993,502,-26
16,2020-04-11,São Paulo,206,6585,10,422,0,0,0,0,6173,180,-10
17,2020-04-12,São Paulo,220,6805,23,445,0,0,0,0,6383,210,-23
18,2020-04-13,São Paulo,26,6831,11,456,0,0,0,0,6386,3,-11
19,2020-04-14,São Paulo,162,6993,64,520,0,0,0,0,6537,151,-64
20,2020-04-15,São Paulo,1031,8024,43,563,0,0,0,0,7504,967,-43
21,2020-04-16,São Paulo,865,8889,47,610,0,0,0,0,8326,822,-47
22,2020-04-17,São Paulo,468,9357,133,743,0,0,0,0,8747,421,-133
23,2020-04-18,São Paulo,770,10127,64,807,0,0,0,0,9384,637,-64
24,2020-04-19,São Paulo,261,10388,40,847,0,0,0,0,9581,197,-40
25,2020-04-20,São Paulo,236,10624,49,896,0,0,0,0,9777,196,-49
26,2020-04-21,São Paulo,641,11265,23,919,0,0,0,0,10369,592,-23
27,2020-04-22,São Paulo,118,11383,0,919,0,0,0,0,10464,95,0
28,2020-04-23,São Paulo,0,11383,205,1124,0,0,0,0,10464,0,-205
29,2020-04-24,São Paulo,819,12202,0,1124,0,0,0,0,11078,614,0
30,2020-04-25,São Paulo,1303,13505,29,1153,0,0,0,0,12381,1303,-29
31,2020-04-26,São Paulo,469,13974,57,1210,0,0,0,0,12821,440,-57
32,2020-04-27,São Paulo,130,14104,62,1272,0,0,0,0,12894,73,-62
33,2020-04-28,São Paulo,1109,15213,65,1337,0,0,0,0,13941,1047,-65
34,2020-04-29,São Paulo,712,15925,81,1418,0,0,0,0,14588,647,-81
35,2020-04-30,São Paulo,2513,18438,96,1514,0,0,0,0,17020,2432,-96
36,2020-05-01,São Paulo,1241,19679,151,1665,0,0,0,0,18165,1145,-151
37,2020-05-02,São Paulo,218,19897,48,1713,0,0,0,0,18232,67,-48
38,2020-05-03,São Paulo,567,20464,31,1744,0,0,0,0,18751,519,-31
39,2020-05-04,São Paulo,384,20848,31,1775,0,0,0,0,19104,353,-31
40,2020-05-05,São Paulo,1401,22249,57,1832,0,0,0,0,20474,1370,-57
41,2020-05-06,São Paulo,1558,23807,96,1928,0,0,0,0,21975,1501,-96
42,2020-05-07,São Paulo,1236,25043,78,2006,0,0,0,0,23115,1140,-78
43,2020-05-08,São Paulo,1230,26273,100,2106,0,0,0,0,24267,1152,-100
44,2020-05-09,São Paulo,1141,27414,81,2187,0,0,0,0,25308,1041,-81
45,2020-05-10,São Paulo,613,28027,81,2268,0,0,0,0,25840,532,-81
46,2020-05-11,São Paulo,62,28089,37,2305,0,0,0,0,25821,-19,-37
47,2020-05-12,São Paulo,2368,30457,125,2430,0,0,0,0,28152,2331,-125
48,2020-05-13,São Paulo,1915,32372,112,2542,0,0,0,0,29942,1790,-112
49,2020-05-14,São Paulo,1469,33841,60,2602,0,0,0,0,31299,1357,-60
50,2020-05-15,São Paulo,3265,37106,79,2681,0,0,0,0,34504,3205,-79
51,2020-05-16,São Paulo,1373,38479,85,2766,0,0,0,0,35798,1294,-85
52,2020-05-17,São Paulo,126,38605,66,2832,0,0,0,0,35839,41,-66
53,2020-05-18,São Paulo,558,39163,13,2845,0,0,0,0,36331,492,-13
54,2020-05-19,São Paulo,1587,40750,95,2940,0,0,0,0,37905,1574,-95
55,2020-05-20,São Paulo,1667,42417,147,3087,0,0,0,0,39477,1572,-147
56,2020-05-21,São Paulo,2099,44516,99,3186,0,0,0,0,41429,1952,-99
57,2020-05-22,São Paulo,1699,46215,69,3255,0,0,0,0,43029,1600,-69
58,2020-05-23,São Paulo,2313,48528,61,3316,0,0,0,0,45273,2244,-61
59,2020-05-24,São Paulo,778,49306,35,3351,0,0,0,0,45990,717,-35
60,2020-05-25,São Paulo,290,49596,39,3390,0,0,0,0,46245,255,-39
61,2020-05-26,São Paulo,2256,51852,31,3421,0,0,0,0,48462,2217,-31
62,2020-05-27,São Paulo,3096,54948,198,3619,0,0,0,0,51527,3065,-198
63,2020-05-28,São Paulo,1827,56775,100,3719,0,0,0,0,53156,1629,-100
64,2020-05-29,São Paulo,3094,59869,104,3823,0,0,0,0,56150,2994,-104
65,2020-05-30,São Paulo,3760,63629,329,4152,0,0,0,0,59806,3656,-329
66,2020-05-31,São Paulo,1409,65038,60,4212,0,0,0,0,60886,1080,-60
67,2020-06-01,São Paulo,678,65716,29,4241,0,0,0,0,61504,618,-29
68,2020-06-02,São Paulo,3282,68998,64,4305,0,0,0,0,64757,3253,-64
69,2020-06-03,São Paulo,3173,72171,175,4480,0,0,0,0,67866,3109,-175
70,2020-06-04,São Paulo,1042,73213,88,4568,0,0,0,0,68733,867,-88
71,2020-06-05,São Paulo,4555,77768,120,4688,0,0,0,0,73200,4467,-120
72,2020-06-06,São Paulo,2112,79880,82,4770,0,0,0,0,75192,1992,-82
73,2020-06-07,São Paulo,1229,81109,43,4813,0,0,0,0,76339,1147,-43
74,2020-06-08,São Paulo,1070,82179,25,4838,0,0,0,0,77366,1027,-25
75,2020-06-09,São Paulo,2683,84862,107,4945,0,0,0,0,80024,2658,-107
76,2020-06-10,São Paulo,1521,86383,178,5123,0,0,0,0,81438,1414,-178
77,2020-06-11,São Paulo,2766,89149,83,5206,0,0,0,0,84026,2588,-83
78,2020-06-12,São Paulo,3021,92170,46,5252,0,0,0,0,86964,2938,-46
79,2020-06-13,São Paulo,2672,94842,114,5366,0,0,0,0,89590,2626,-114
80,2020-06-14,São Paulo,2403,97245,62,5428,0,0,0,0,91879,2289,-62
81,2020-06-15,São Paulo,3382,100627,46,5474,0,0,0,0,95199,3320,-46
82,2020-06-16,São Paulo,5031,105658,298,5772,0,0,0,0,100184,4985,-298
83,2020-06-17,São Paulo,3534,109192,170,5942,0,0,0,0,103420,3236,-170
84,2020-06-18,São Paulo,0,109192,205,6147,0,0,0,0,103250,-170,-205
85,2020-06-19,São Paulo,0,109192,68,6215,0,0,0,0,103045,-205,-68
86,2020-06-20,São Paulo,8576,117768,103,6318,0,0,0,0,111553,8508,-103
87,2020-06-21,São Paulo,940,118708,65,6383,0,0,0,0,112390,837,-65
88,2020-06-22,São Paulo,0,118708,71,6454,0,0,0,0,112325,-65,-71
89,2020-06-23,São Paulo,641,119349,153,6607,0,0,0,0,112895,570,-153
90,2020-06-24,São Paulo,18990,138339,115,6722,0,0,0,0,131732,18837,-115
91,2020-06-25,São Paulo,4411,142750,70,6792,0,0,0,0,136028,4296,-70
92,2020-06-26,São Paulo,4366,147116,74,6866,0,0,0,0,140324,4296,-74
93,2020-06-27,São Paulo,420,147536,54,6920,0,0,0,0,140670,346,-54
94,2020-06-28,São Paulo,3221,150757,25,6945,0,0,0,0,143837,3167,-25
95,2020-06-29,São Paulo,153,150910,37,6982,0,0,0,0,143965,128,-37
96,2020-06-30,São Paulo,504,151414,141,7123,0,0,0,0,144432,467,-141
97,2020-07-01,São Paulo,8923,160337,204,7327,0,0,0,0,153214,8782,-204
98,2020-07-02,São Paulo,2849,163186,91,7418,0,0,0,0,155859,2645,-91
99,2020-07-03,São Paulo,2380,165566,67,7485,0,0,0,0,158148,2289,-67
100,2020-07-04,São Paulo,2822,168388,43,7528,0,0,0,0,160903,2755,-43
101,2020-07-05,São Paulo,1954,170342,46,7574,0,0,0,0,162814,1911,-46
102,2020-07-06,São Paulo,827,171169,34,7608,0,0,0,0,163595,781,-34
103,2020-07-07,São Paulo,2411,173580,131,7739,0,0,0,0,165972,2377,-131
104,2020-07-08,São Paulo,2723,176303,150,7889,0,0,0,0,168564,2592,-150
105,2020-07-09,São Paulo,1815,178118,98,7987,0,0,0,0,170229,1665,-98
106,2020-07-10,São Paulo,313,178431,85,8072,0,0,0,0,170444,215,-85
107,2020-07-11,São Paulo,350,178781,74,8146,0,0,0,0,170709,265,-74
108,2020-07-12,São Paulo,118,178899,42,8188,0,0,0,0,170753,44,-42
109,2020-07-13,São Paulo,98,178997,30,8218,0,0,0,0,170809,56,-30
110,2020-07-14,São Paulo,404,179401,225,8443,0,0,0,0,171183,374,-225
111,2020-07-15,São Paulo,449,179850,131,8574,0,0,0,0,171407,224,-131
112,2020-07-16,São Paulo,600,180450,134,8708,0,0,0,0,171876,469,-134
113,2020-07-17,São Paulo,306,180756,51,8759,0,0,0,0,172048,172,-51
114,2020-07-18,São Paulo,319,181075,0,8759,0,0,0,0,172316,268,0
115,2020-07-19,São Paulo,83,181158,0,8759,0,0,0,0,172399,83,0
116,2020-07-20,São Paulo,120,181278,0,8759,0,0,0,0,172519,120,0
117,2020-07-21,São Paulo,491,181769,277,9036,0,0,0,0,173010,491,-277
118,2020-07-22,São Paulo,18601,200370,0,9036,0,0,0,0,191334,18324,0
119,2020-07-23,São Paulo,2201,202571,220,9256,0,0,0,0,193535,2201,-220
120,2020-07-24,São Paulo,737,203308,77,9333,0,0,0,0,194052,517,-77
121,2020-07-25,São Paulo,4436,207744,70,9403,0,0,0,0,198411,4359,-70
122,2020-07-26,São Paulo,0,207744,0,9403,0,0,0,0,198341,-70,0
123,2020-07-27,São Paulo,189,207933,0,9403,0,0,0,0,198530,189,0
124,2020-07-28,São Paulo,5503,213436,137,9540,0,0,0,0,204033,5503,-137
125,2020-07-29,São Paulo,6858,220294,121,9661,0,0,0,0,210754,6721,-121
126,2020-07-30,São Paulo,3277,223571,49,9710,0,0,0,0,213910,3156,-49
127,2020-07-31,São Paulo,2016,225587,42,9752,0,0,0,0,215877,1967,-42
128,2020-08-01,São Paulo,4728,230315,82,9834,0,0,0,0,220563,4686,-82
129,2020-08-02,São Paulo,60,230375,29,9863,0,0,0,0,220541,-22,-29
130,2020-08-03,São Paulo,37,230412,20,9883,0,0,0,0,220549,8,-20
131,2020-08-04,São Paulo,3051,233463,59,9942,0,0,0,0,223580,3031,-59
132,2020-08-05,São Paulo,2715,236178,113,10055,0,0,0,0,226236,2656,-113
133,2020-08-06,São Paulo,6592,242770,104,10159,0,0,0,0,232715,6479,-104
134,2020-08-07,São Paulo,1561,244331,87,10246,0,0,0,0,234172,1457,-87
135,2020-08-08,São Paulo,2319,246650,57,10303,0,0,0,0,236404,2232,-57
136,2020-08-09,São Paulo,80,246730,20,10323,0,0,0,0,236427,23,-20
137,2020-08-10,São Paulo,57,246787,16,10339,0,0,0,0,236464,37,-16
138,2020-08-11,São Paulo,2963,249750,134,10473,0,0,0,0,239411,2947,-134
139,2020-08-12,São Paulo,8731,258481,140,10613,0,0,0,0,248008,8597,-140
140,2020-08-13,São Paulo,8758,267239,62,10675,0,0,0,0,256626,8618,-62
141,2020-08-14,São Paulo,2595,269834,83,10758,0,0,0,0,259159,2533,-83
142,2020-08-15,São Paulo,1598,271432,51,10809,0,0,0,0,260674,1515,-51
143,2020-08-16,São Paulo,638,272070,17,10826,0,0,0,0,261261,587,-17
144,2020-08-17,São Paulo,363,272433,34,10860,0,0,0,0,261607,346,-34
145,2020-08-18,São Paulo,814,273247,35,10895,0,0,0,0,262387,780,-35
146,2020-08-19,São Paulo,2287,275534,174,11069,0,0,0,0,264639,2252,-174
147,2020-08-20,São Paulo,1916,277450,146,11215,0,0,0,0,266381,1742,-146
148,2020-08-21,São Paulo,1120,278570,214,11429,0,0,0,0,267355,974,-214
149,2020-08-22,São Paulo,4191,282761,2,11431,0,0,0,0,271332,3977,-2
150,2020-08-23,São Paulo,1309,284070,23,11454,0,0,0,0,272639,1307,-23
151,2020-08-24,São Paulo,101,284171,25,11479,0,0,0,0,272717,78,-25
152,2020-08-25,São Paulo,2808,286979,94,11573,0,0,0,0,275500,2783,-94
153,2020-08-26,São Paulo,2085,289064,250,11823,0,0,0,0,277491,1991,-250
154,2020-08-27,São Paulo,2689,291753,110,11933,0,0,0,0,279930,2439,-110
155,2020-08-28,São Paulo,2001,293754,52,11985,0,0,0,0,281821,1891,-52
156,2020-08-29,São Paulo,1226,294980,24,12009,0,0,0,0,282995,1174,-24
157,2020-08-30,São Paulo,270,295250,44,12053,0,0,0,0,283241,246,-44
158,2020-08-31,São Paulo,185,295435,7,12060,0,0,0,0,283382,141,-7
159,2020-09-01,São Paulo,3263,298698,83,12143,0,0,0,0,286638,3256,-83
160,2020-09-02,São Paulo,2145,300843,133,12276,0,0,0,0,288700,2062,-133
161,2020-09-03,São Paulo,2391,303234,120,12396,0,0,0,0,290958,2258,-120
162,2020-09-04,São Paulo,1520,304754,162,12558,0,0,0,0,292358,1400,-162
163,2020-09-05,São Paulo,1288,306042,27,12585,0,0,0,0,293484,1126,-27
164,2020-09-06,São Paulo,319,306361,0,12585,0,0,0,0,293776,292,0
165,2020-09-07,São Paulo,168,306529,10,12595,0,0,0,0,293944,168,-10
166,2020-09-08,São Paulo,480,307009,0,12595,0,0,0,0,294414,470,0
167,2020-09-09,São Paulo,1831,308840,67,12662,0,0,0,0,296245,1831,-67
168,2020-09-10,São Paulo,1649,310489,105,12767,0,0,0,0,297827,1582,-105
169,2020-09-11,São Paulo,1600,312089,36,12803,0,0,0,0,299322,1495,-36
170,2020-09-12,São Paulo,1462,313551,14,12817,0,0,0,0,300748,1426,-14
171,2020-09-13,São Paulo,307,313858,33,12850,0,0,0,0,301041,293,-33
172,2020-09-14,São Paulo,0,313858,12,12862,0,0,0,0,301008,-33,-12
173,2020-09-15,São Paulo,2018,315876,68,12930,0,0,0,0,303014,2006,-68
174,2020-09-16,São Paulo,1527,317403,181,13111,0,0,0,0,304473,1459,-181
175,2020-09-17,São Paulo,1565,318968,55,13166,0,0,0,0,305857,1384,-55
176,2020-09-18,São Paulo,1709,320677,78,13244,0,0,0,0,307511,1654,-78
177,2020-09-19,São Paulo,254,320931,35,13279,0,0,0,0,307687,176,-35
178,2020-09-20,São Paulo,30,320961,43,13322,0,0,0,0,307682,-5,-43
179,2020-09-21,São Paulo,52,321013,17,13339,0,0,0,0,307691,9,-17
180,2020-09-22,São Paulo,348,321361,26,13365,0,0,0,0,308022,331,-26
181,2020-09-23,São Paulo,272,321633,98,13463,0,0,0,0,308268,246,-98
182,2020-09-24,São Paulo,218,321851,64,13527,0,0,0,0,308388,120,-64
183,2020-09-25,São Paulo,6426,328277,34,13561,0,0,0,0,314750,6362,-34
184,2020-09-26,São Paulo,1156,329433,9,13570,0,0,0,0,315872,1122,-9
185,2020-09-27,São Paulo,271,329704,0,13570,0,0,0,0,316134,262,0
186,2020-09-28,São Paulo,399,330103,10,13580,0,0,0,0,316533,399,-10
187,2020-09-29,São Paulo,1419,331522,105,13685,0,0,0,0,317942,1409,-105
188,2020-09-30,São Paulo,1428,332950,18,13703,0,0,0,0,319265,1323,-18
189,2020-10-01,São Paulo,1227,334177,19,13722,0,0,0,0,320474,1209,-19
190,2020-10-02,São Paulo,1153,335330,20,13742,0,0,0,0,321608,1134,-20
191,2020-10-03,São Paulo,1440,336770,1,13743,0,0,0,0,323028,1420,-1
192,2020-10-04,São Paulo,303,337073,0,13743,0,0,0,0,323330,302,0
193,2020-10-05,São Paulo,133,337206,78,13821,0,0,0,0,323463,133,-78
194,2020-10-06,São Paulo,0,337206,51,13872,0,0,0,0,323385,-78,-51
195,2020-10-07,São Paulo,2571,339777,130,14002,0,0,0,0,325905,2520,-130
196,2020-10-08,São Paulo,965,340742,40,14042,0,0,0,0,326740,835,-40
197,2020-10-09,São Paulo,1603,342345,0,14042,0,0,0,0,328303,1563,0
198,2020-10-10,São Paulo,1229,343574,36,14078,0,0,0,0,329532,1229,-36
199,2020-10-11,São Paulo,318,343892,12,14090,0,0,0,0,329814,282,-12
200,2020-10-12,São Paulo,145,344037,0,14090,0,0,0,0,329947,133,0
201,2020-10-13,São Paulo,211,344248,0,14090,0,0,0,0,330158,211,0
202,2020-10-14,São Paulo,1247,345495,48,14138,0,0,0,0,331405,1247,-48
203,2020-10-15,São Paulo,1523,347018,40,14178,0,0,0,0,332880,1475,-40
204,2020-10-16,São Paulo,1360,348378,21,14199,0,0,0,0,334200,1320,-21
205,2020-10-17,São Paulo,201,348579,25,14224,0,0,0,0,334380,180,-25
206,2020-10-18,São Paulo,1111,349690,1,14225,0,0,0,0,335466,1086,-1
207,2020-10-19,São Paulo,1021,350711,20,14245,0,0,0,0,336486,1020,-20
208,2020-10-20,São Paulo,1166,351877,8,14253,0,0,0,0,337632,1146,-8
209,2020-10-21,São Paulo,1076,352953,31,14284,0,0,0,0,338700,1068,-31
210,2020-10-22,São Paulo,999,353952,9,14293,0,0,0,0,339668,968,-9
211,2020-10-23,São Paulo,1784,355736,22,14315,0,0,0,0,341443,1775,-22
212,2020-10-24,São Paulo,1440,357176,3,14318,0,0,0,0,342861,1418,-3
213,2020-10-25,São Paulo,410,357586,7,14325,0,0,0,0,343268,407,-7
214,2020-10-26,São Paulo,163,357749,15,14340,0,0,0,0,343424,156,-15
215,2020-10-27,São Paulo,1767,359516,3,14343,0,0,0,0,345176,1752,-3
216,2020-10-28,São Paulo,1550,361066,34,14377,0,0,0,0,346723,1547,-34
217,2020-10-29,São Paulo,1399,362465,6,14383,0,0,0,0,348088,1365,-6
218,2020-10-30,São Paulo,1398,363863,15,14398,0,0,0,0,349480,1392,-15
219,2020-10-31,São Paulo,788,364651,0,14398,0,0,0,0,350253,773,0
220,2020-11-01,São Paulo,23,364674,0,14398,0,0,0,0,350276,23,0
221,2020-11-02,São Paulo,390,365064,0,14398,0,0,0,0,350666,390,0
222,2020-11-03,São Paulo,297,365361,104,14502,0,0,0,0,350963,297,-104
223,2020-11-04,São Paulo,1119,366480,43,14545,0,0,0,0,351978,1015,-43
224,2020-11-05,São Paulo,1121,367601,27,14572,0,0,0,0,353056,1078,-27
225,2020-11-06,São Paulo,0,367601,2,14574,0,0,0,0,353029,-27,-2
226,2020-11-07,São Paulo,0,367601,7,14581,0,0,0,0,353027,-2,-7
227,2020-11-08,São Paulo,0,367601,15,14596,0,0,0,0,353020,-7,-15
228,2020-11-09,São Paulo,0,367601,18,14614,0,0,0,0,353005,-15,-18
229,2020-11-10,São Paulo,6453,374054,52,14666,0,0,0,0,359440,6435,-52
230,2020-11-11,São Paulo,2227,376281,31,14697,0,0,0,0,361615,2175,-31
231,2020-11-12,São Paulo,1879,378160,12,14709,0,0,0,0,363463,1848,-12
232,2020-11-13,São Paulo,0,378160,4,14713,0,0,0,0,363451,-12,-4
233,2020-11-14,São Paulo,4028,382188,10,14723,0,0,0,0,367475,4024,-10
234,2020-11-15,São Paulo,393,382581,10,14733,0,0,0,0,367858,383,-10
235,2020-11-16,São Paulo,220,382801,35,14768,0,0,0,0,368068,210,-35
236,2020-11-17,São Paulo,2415,385216,12,14780,0,0,0,0,370448,2380,-12
237,2020-11-18,São Paulo,2012,387228,40,14820,0,0,0,0,372448,2000,-40
238,2020-11-19,São Paulo,2481,389709,14,14834,0,0,0,0,374889,2441,-14
239,2020-11-20,São Paulo,2574,392283,21,14855,0,0,0,0,377449,2560,-21
240,2020-11-21,São Paulo,1784,394067,8,14863,0,0,0,0,379212,1763,-8
241,2020-11-22,São Paulo,709,394776,13,14876,0,0,0,0,379913,701,-13
242,2020-11-23,São Paulo,125,394901,38,14914,0,0,0,0,380025,112,-38
243,2020-11-24,São Paulo,1813,396714,100,15014,0,0,0,0,381800,1775,-100
244,2020-11-25,São Paulo,2668,399382,48,15062,0,0,0,0,384368,2568,-48
245,2020-11-26,São Paulo,1334,400716,20,15082,0,0,0,0,385654,1286,-20
246,2020-11-27,São Paulo,1052,401768,34,15116,0,0,0,0,386686,1032,-34
247,2020-11-28,São Paulo,4594,406362,12,15128,0,0,0,0,391246,4560,-12
248,2020-11-29,São Paulo,541,406903,2,15130,0,0,0,0,391775,529,-2
249,2020-11-30,São Paulo,223,407126,20,15150,0,0,0,0,391996,221,-20
250,2020-12-01,São Paulo,2707,409833,43,15193,0,0,0,0,394683,2687,-43
251,2020-12-02,São Paulo,6049,415882,54,15247,0,0,0,0,400689,6006,-54
252,2020-12-03,São Paulo,2320,418202,42,15289,0,0,0,0,402955,2266,-42
253,2020-12-04,São Paulo,2401,420603,40,15329,0,0,0,0,405314,2359,-40
254,2020-12-05,São Paulo,2418,423021,18,15347,0,0,0,0,407692,2378,-18
255,2020-12-06,São Paulo,754,423775,26,15373,0,0,0,0,408428,736,-26
256,2020-12-07,São Paulo,225,424000,28,15401,0,0,0,0,408627,199,-28
257,2020-12-08,São Paulo,2439,426439,37,15438,0,0,0,0,411038,2411,-37
258,2020-12-09,São Paulo,2795,429234,67,15505,0,0,0,0,413796,2758,-67
259,2020-12-10,São Paulo,14461,443695,48,15553,0,0,0,0,428190,14394,-48
260,2020-12-11,São Paulo,2644,446339,45,15598,0,0,0,0,430786,2596,-45
261,2020-12-12,São Paulo,2096,448435,9,15607,0,0,0,0,432837,2051,-9
262,2020-12-13,São Paulo,254,448689,19,15626,0,0,0,0,433082,245,-19
263,2020-12-14,São Paulo,466,449155,50,15676,0,0,0,0,433529,447,-50
264,2020-12-15,São Paulo,1113,450268,25,15701,0,0,0,0,434592,1063,-25
265,2020-12-16,São Paulo,3481,453749,80,15781,0,0,0,0,438048,3456,-80
266,2020-12-17,São Paulo,2823,456572,30,15811,0,0,0,0,440791,2743,-30
267,2020-12-18,São Paulo,2674,459246,43,15854,0,0,0,0,443435,2644,-43
268,2020-12-19,São Paulo,2420,461666,26,15880,0,0,0,0,445812,2377,-26
269,2020-12-20,São Paulo,818,462484,14,15894,0,0,0,0,446604,792,-14
270,2020-12-21,São Paulo,443,462927,17,15911,0,0,0,0,447033,429,-17
271,2020-12-22,São Paulo,3037,465964,35,15946,0,0,0,0,450053,3020,-35
272,2020-12-23,São Paulo,3025,468989,13,15959,0,0,0,0,453043,2990,-13
273,2020-12-24,São Paulo,0,468989,83,16042,0,0,0,0,453030,-13,-83
274,2020-12-25,São Paulo,0,468989,33,16075,0,0,0,0,452947,-83,-33
275,2020-12-26,São Paulo,4542,473531,9,16084,0,0,0,0,457456,4509,-9
276,2020-12-27,São Paulo,789,474320,5,16089,0,0,0,0,458236,780,-5
277,2020-12-28,São Paulo,626,474946,3,16092,0,0,0,0,458857,621,-3
278,2020-12-29,São Paulo,3884,478830,71,16163,0,0,0,0,462738,3881,-71
279,2020-12-30,São Paulo,3722,482552,218,16381,0,0,0,0,466389,3651,-218
280,2020-12-31,São Paulo,0,482522,2,16383,0,0,0,0,466141,-248,-2
281,2021-01-01,São Paulo,0,482522,25,16408,0,0,0,0,466139,-2,-25
282,2021-01-02,São Paulo,4717,487239,49,16457,0,0,0,0,470831,4692,-49
283,2021-01-03,São Paulo,988,488227,6,16463,0,0,0,0,471770,939,-6
284,2021-01-04,São Paulo,427,488654,1,16464,0,0,0,0,472191,421,-1
285,2021-01-05,São Paulo,3424,492078,1,16465,0,0,0,0,475614,3423,-1
286,2021-01-06,São Paulo,3683,495761,90,16555,0,0,0,0,479296,3682,-90
287,2021-01-07,São Paulo,3515,499276,171,16726,0,0,0,0,482721,3425,-171
288,2021-01-08,São Paulo,4653,503929,82,16808,0,0,0,0,487203,4482,-82
289,2021-01-09,São Paulo,3231,507160,28,16836,0,0,0,0,490352,3149,-28
290,2021-01-10,São Paulo,1086,508246,45,16881,0,0,0,0,491410,1058,-45
291,2021-01-11,São Paulo,779,509025,25,16906,0,0,0,0,492144,734,-25
292,2021-01-12,São Paulo,2480,511505,84,16990,0,0,0,0,494599,2455,-84
293,2021-01-13,São Paulo,4274,515779,117,17107,0,0,0,0,498789,4190,-117
294,2021-01-14,São Paulo,3597,519376,66,17173,0,0,0,0,502269,3480,-66
295,2021-01-15,São Paulo,3991,523367,54,17227,0,0,0,0,506194,3925,-54
296,2021-01-16,São Paulo,3530,526897,17,17244,0,0,0,0,509670,3476,-17
297,2021-01-17,São Paulo,1159,528056,37,17281,0,0,0,0,510812,1142,-37
298,2021-01-18,São Paulo,753,528809,34,17315,0,0,0,0,511528,716,-34
299,2021-01-19,São Paulo,4410,533219,54,17369,0,0,0,0,515904,4376,-54
300,2021-01-20,São Paulo,3894,537113,124,17493,0,0,0,0,519744,3840,-124
301,2021-01-21,São Paulo,3505,540618,79,17572,0,0,0,0,523125,3381,-79
302,2021-01-22,São Paulo,2142,542760,184,17756,0,0,0,0,525188,2063,-184
303,2021-01-23,São Paulo,3763,546523,0,17756,0,0,0,0,528767,3579,0
304,2021-01-24,São Paulo,1135,547658,0,17756,0,0,0,0,529902,1135,0
305,2021-01-25,São Paulo,578,548236,0,17756,0,0,0,0,530480,578,0
306,2021-01-26,São Paulo,1550,549786,67,17823,0,0,0,0,532030,1550,-67
307,2021-01-27,São Paulo,4081,553867,95,17918,0,0,0,0,536044,4014,-95
308,2021-01-28,São Paulo,4138,558005,144,18062,0,0,0,0,540087,4043,-144
309,2021-01-29,São Paulo,3974,561979,55,18117,0,0,0,0,543917,3830,-55
310,2021-01-30,São Paulo,2740,564719,30,18147,0,0,0,0,546602,2685,-30
311,2021-01-31,São Paulo,813,565532,1,18148,0,0,0,0,547385,783,-1
312,2021-02-01,São Paulo,614,566146,92,18240,0,0,0,0,547998,613,-92
313,2021-02-02,São Paulo,4266,570412,44,18284,0,0,0,0,552172,4174,-44
314,2021-02-03,São Paulo,3486,573898,83,18367,0,0,0,0,555614,3442,-83
315,2021-02-04,São Paulo,4326,578224,106,18473,0,0,0,0,559857,4243,-106
316,2021-02-05,São Paulo,3016,581240,97,18570,0,0,0,0,562767,2910,-97
317,2021-02-06,São Paulo,2981,584221,78,18648,0,0,0,0,565651,2884,-78
318,2021-02-07,São Paulo,959,585180,2,18650,0,0,0,0,566532,881,-2
319,2021-02-08,São Paulo,585,585765,53,18703,0,0,0,0,567115,583,-53
320,2021-02-09,São Paulo,3399,589164,75,18778,0,0,0,0,570461,3346,-75
321,2021-02-10,São Paulo,3326,592490,112,18890,0,0,0,0,573712,3251,-112
322,2021-02-11,São Paulo,5274,597764,51,18941,0,0,0,0,578874,5162,-51
323,2021-02-12,São Paulo,5618,603382,78,19019,0,0,0,0,584441,5567,-78
324,2021-02-13,São Paulo,2882,606264,49,19068,0,0,0,0,587245,2804,-49
325,2021-02-14,São Paulo,2734,608998,14,19082,0,0,0,0,589930,2685,-14
326,2021-02-15,São Paulo,2741,611739,47,19129,0,0,0,0,592657,2727,-47
327,2021-02-16,São Paulo,2913,614652,15,19144,0,0,0,0,595523,2866,-15
328,2021-02-17,São Paulo,3109,617761,115,19259,0,0,0,0,598617,3094,-115
329,2021-02-18,São Paulo,15354,633115,33,19292,0,0,0,0,613856,15239,-33
330,2021-02-19,São Paulo,5384,638499,53,19345,0,0,0,0,619207,5351,-53
331,2021-02-20,São Paulo,5149,643648,10,19355,0,0,0,0,624303,5096,-10
332,2021-02-21,São Paulo,3562,647210,40,19395,0,758,0,0,627855,3552,-40
333,2021-02-22,São Paulo,3352,650562,0,19382,0,9600,0,0,631167,3312,13
334,2021-02-23,São Paulo,5479,656041,74,19456,0,9531,0,0,636659,5492,-74
335,2021-02-24,São Paulo,5779,661820,103,19559,0,6820,0,0,642364,5705,-103
336,2021-02-25,São Paulo,2696,664516,0,19559,0,0,0,0,644957,2593,0
337,2021-02-26,São Paulo,8070,672586,111,19670,0,15741,0,0,653027,8070,-111
338,2021-02-27,São Paulo,4970,677556,6,19676,0,0,0,0,657886,4859,-6
339,2021-02-28,São Paulo,2696,680252,2,19678,0,5941,0,0,660576,2690,-2
340,2021-03-01,São Paulo,4367,684619,312,19990,0,5175,0,0,664941,4365,-312
341,2021-03-02,São Paulo,5270,689889,44,20034,0,12513,0,0,669899,4958,-44
342,2021-03-03,São Paulo,5824,695713,107,20141,0,9078,0,0,675679,5780,-107
343,2021-03-04,São Paulo,6074,701787,90,20231,0,11619,0,0,681646,5967,-90
344,2021-03-05,São Paulo,5911,707698,77,20308,0,17293,0,0,687467,5821,-77
345,2021-03-06,São Paulo,5530,713228,12,20320,0,9292,0,0,692920,5453,-12
346,2021-03-07,São Paulo,4240,717468,55,20375,0,1384,0,0,697148,4228,-55
347,2021-03-08,São Paulo,3859,721327,28,20403,0,10326,0,0,700952,3804,-28
348,2021-03-09,São Paulo,5984,727311,94,20497,0,10369,0,0,706908,5956,-94
349,2021-03-10,São Paulo,6629,733940,76,20573,0,11467,0,0,713443,6535,-76
350,2021-03-11,São Paulo,5890,739830,91,20664,0,12455,0,0,719257,5814,-91
351,2021-03-12,São Paulo,5132,744962,79,20743,0,15022,0,0,724298,5041,-79
352,2021-03-13,São Paulo,6447,751409,45,20788,0,5753,0,0,730666,6368,-45
353,2021-03-14,São Paulo,4741,756150,65,20853,0,959,0,0,735362,4696,-65
354,2021-03-15,São Paulo,4185,760335,171,21024,0,6257,0,0,739482,4120,-171
355,2021-03-16,São Paulo,4772,765107,109,21133,0,9024,0,0,744083,4601,-109
356,2021-03-17,São Paulo,6362,771469,240,21373,0,8701,0,0,750336,6253,-240
357,2021-03-18,São Paulo,5913,777382,3,21376,0,8150,0,0,756009,5673,-3
358,2021-03-19,São Paulo,5828,783210,241,21617,0,5744,0,0,761834,5825,-241
359,2021-03-20,São Paulo,5562,788772,188,21805,0,3273,0,0,767155,5321,-188
360,2021-03-21,São Paulo,2696,791468,57,21862,0,336,0,0,769663,2508,-57
361,2021-03-22,São Paulo,6086,797554,165,22027,0,6040,0,0,775692,6029,-165
362,2021-03-23,São Paulo,4361,801915,18,22045,0,11098,0,0,779888,4196,-18
363,2021-03-24,São Paulo,6003,807918,106,22151,0,23336,0,0,785873,5985,-106
364,2021-03-25,São Paulo,5829,813747,275,22426,0,24659,0,0,791596,5723,-275
365,2021-03-26,São Paulo,6102,819849,297,22723,0,14847,0,0,797423,5827,-297
366,2021-03-27,São Paulo,26720,846569,79,22802,0,8447,0,0,823846,26423,-79
367,2021-03-28,São Paulo,2696,849265,138,22940,0,1743,0,0,826463,2617,-138
368,2021-03-29,São Paulo,5672,854937,383,23323,0,8002,0,0,831997,5534,-383
369,2021-03-30,São Paulo,7624,862561,70,23393,0,11426,0,0,839238,7241,-70
370,2021-03-31,São Paulo,14020,876581,85,23478,0,11038,0,0,853188,13950,-85
371,2021-04-01,São Paulo,4906,749383,72,23550,18610,1332654,11152,471054,725905,-127283,-72
372,2021-04-02,São Paulo,3537,752920,32,23582,25651,1358305,5971,477025,729370,3465,-32
373,2021-04-03,São Paulo,1510,754430,475,24057,18626,1376931,1600,478625,730848,1478,-475
374,2021-04-04,São Paulo,1634,756064,178,24235,5826,1382757,679,479304,732007,1159,-178
375,2021-04-05,São Paulo,1223,757287,686,24921,17575,1400332,26320,505624,733052,1045,-686
376,2021-04-06,São Paulo,4310,761597,15,24936,31080,1431412,36670,542294,736676,3624,-15
377,2021-04-07,São Paulo,2435,764032,398,25334,48077,1479489,32748,575042,739096,2420,-398
378,2021-04-08,São Paulo,2198,766230,802,26136,28848,1508337,20979,596021,740896,1800,-802
379,2021-04-09,São Paulo,708,766938,425,26561,17269,1525606,56489,652510,740802,-94,-425
380,2021-04-10,São Paulo,633,767571,253,26814,23177,1548783,42964,695474,741010,208,-253
381,2021-04-11,São Paulo,0,767571,117,26931,12269,1561052,3914,699388,740757,-253,-117
382,2021-04-12,São Paulo,211,767782,276,27207,31827,1592879,20142,719530,740851,94,-276
383,2021-04-13,São Paulo,934,768716,6,27213,46155,1639034,27447,746977,741509,658,-6
384,2021-04-14,São Paulo,2538,771254,287,27500,29139,1668173,17346,764323,744041,2532,-287
385,2021-04-15,São Paulo,2141,773395,319,27819,20847,1689020,16588,780911,745895,1854,-319
386,2021-04-16,São Paulo,654,774049,224,28043,15589,1704609,69898,850809,746230,335,-224
387,2021-04-17,São Paulo,4902,778951,171,28214,9174,1713783,47769,898578,750908,4678,-171
388,2021-04-18,São Paulo,0,778951,48,28262,2010,1715793,4865,903443,750737,-171,-48
389,2021-04-19,São Paulo,186148,965099,240,28502,56904,1772697,25390,928833,936837,186100,-240
390,2021-04-20,São Paulo,6487,971586,3,28505,-37455,1735242,34039,962872,943084,6247,-3
391,2021-04-21,São Paulo,5772,977358,203,28708,89833,1825075,21853,984725,948853,5769,-203
392,2021-04-22,São Paulo,3399,980757,61,28769,50653,1875728,17062,1001787,952049,3196,-61
393,2021-04-23,São Paulo,6026,986783,263,29032,48234,1923962,35593,1037380,958014,5965,-263
394,2021-04-24,São Paulo,4900,991683,138,29170,32291,1956253,23913,1061293,962651,4637,-138
395,2021-04-25,São Paulo,0,991683,41,29211,4133,1960386,4658,1065951,962513,-138,-41
396,2021-04-26,São Paulo,2916,994599,258,29469,0,1960386,0,1065951,965388,2875,-258
397,2021-04-27,São Paulo,6077,1000676,3,29472,33185,1993571,53111,1119062,971207,5819,-3
398,2021-04-28,São Paulo,6087,1006763,204,29676,8248,2001819,26016,1145078,977291,6084,-204
399,2021-04-29,São Paulo,36500,1043263,587,30263,38702,2040521,23045,1168123,1013587,36296,-587
400,2021-04-30,São Paulo,4798,1048061,187,30450,39227,2079748,21428,1189551,1017798,4211,-187
401,2021-05-01,São Paulo,4129,1052190,40,30490,15330,2095078,20217,1209768,1021740,3942,-40
402,2021-05-02,São Paulo,0,1052190,17,30507,1859,2096937,4280,1214048,1021700,-40,-17
403,2021-05-03,São Paulo,2464,1054654,202,30709,7259,2104196,25398,1239446,1024147,2447,-202
404,2021-05-04,São Paulo,4658,1059312,30,30739,12624,2116820,32556,1272002,1028603,4456,-30
405,2021-05-05,São Paulo,4416,1063728,33,30772,10694,2127514,31460,1303462,1032989,4386,-33
406,2021-05-06,São Paulo,4252,1067980,180,30952,97002,2224516,51542,1355004,1037208,4219,-180
407,2021-05-07,São Paulo,4256,1072236,142,31094,91791,2316307,14418,1369422,1041284,4076,-142
408,2021-05-08,São Paulo,3366,1075602,89,31183,61318,2377625,12921,1382343,1044508,3224,-89
409,2021-05-09,São Paulo,0,1075602,35,31218,14351,2391976,3537,1385880,1044419,-89,-35
410,2021-05-10,São Paulo,2864,1078466,136,31354,13904,2405880,8306,1394186,1047248,2829,-136
411,2021-05-11,São Paulo,5163,1083629,1,31355,27094,2432974,12063,1406249,1052275,5027,-1
412,2021-05-12,São Paulo,4865,1088494,143,31498,53629,2486603,8264,1414513,1057139,4864,-143
413,2021-05-13,São Paulo,4286,1092780,529,32027,51986,2538589,8975,1423488,1061282,4143,-529
414,2021-05-14,São Paulo,4706,1097486,95,32122,65192,2603781,8352,1431840,1065459,4177,-95
415,2021-05-15,São Paulo,4058,1101544,51,32173,79016,2682797,5854,1437694,1069422,3963,-51
416,2021-05-16,São Paulo,0,1101544,110,32283,27262,2710059,1592,1439286,1069371,-51,-110
417,2021-05-17,São Paulo,3653,1105197,111,32394,19328,2729387,3387,1442673,1072914,3543,-111
418,2021-05-18,São Paulo,4721,1109918,0,32394,42737,2772124,4578,1447251,1077524,4610,0
419,2021-05-19,São Paulo,4555,1114473,158,32552,52269,2824393,4030,1451281,1082079,4555,-158
420,2021-05-20,São Paulo,4853,1119326,97,32649,53503,2877896,4596,1455877,1086774,4695,-97
421,2021-05-21,São Paulo,4483,1123809,90,32739,81852,2959748,5481,1461358,1091160,4386,-90
422,2021-05-22,São Paulo,4349,1128158,98,32837,45126,3004874,7520,1468878,1095419,4259,-98
423,2021-05-23,São Paulo,0,1128158,55,32892,5677,3010551,2647,1471525,1095321,-98,-55
424,2021-05-24,São Paulo,2752,1130910,168,33060,25924,3036475,12981,1484506,1098018,2697,-168
425,2021-05-25,São Paulo,4946,1135856,29,33089,53504,3089979,15544,1500050,1102796,4778,-29
426,2021-05-26,São Paulo,5010,1140866,82,33171,48776,3138755,15091,1515141,1107777,4981,-82
427,2021-05-27,São Paulo,2239,1143105,127,33298,43162,3181917,15303,1530444,1109934,2157,-127
428,2021-05-28,São Paulo,469,1143574,204,33502,61670,3243587,12526,1542970,1110276,342,-204
429,2021-05-29,São Paulo,0,1143574,4,33506,68942,3312529,9731,1552701,1110072,-204,-4
430,2021-05-30,São Paulo,0,1143574,4,33510,24968,3337497,3252,1555953,1110068,-4,-4
431,2021-05-31,São Paulo,12908,1156482,38,33548,23578,3361075,6234,1562187,1122972,12904,-38
432,2021-06-01,São Paulo,5298,1161780,0,33548,46572,3407647,17098,1579285,1128232,5260,0
433,2021-06-02,São Paulo,5363,1167143,126,33674,60755,3468402,14360,1593645,1133595,5363,-126
434,2021-06-03,São Paulo,4848,1171991,225,33899,67340,3535742,15433,1609078,1138317,4722,-225
435,2021-06-04,São Paulo,4386,1176377,263,34162,50242,3585984,13228,1622306,1142478,4161,-263
436,2021-06-05,São Paulo,4077,1180454,85,34247,49764,3635748,17087,1639393,1146292,3814,-85
437,2021-06-06,São Paulo,0,1180454,19,34266,16279,3652027,5307,1644700,1146207,-85,-19
438,2021-06-07,São Paulo,4335,1184789,74,34340,25250,3677277,4741,1649441,1150523,4316,-74
439,2021-06-08,São Paulo,4703,1189492,56,34396,49959,3727236,6704,1656145,1155152,4629,-56
440,2021-06-09,São Paulo,4255,1193747,141,34537,45800,3773036,5110,1661255,1159351,4199,-141
441,2021-06-10,São Paulo,6091,1199838,301,34838,44059,3817095,4335,1665590,1165301,5950,-301
442,2021-06-11,São Paulo,5074,1204912,93,34931,61470,3878565,3610,1669200,1170074,4773,-93
443,2021-06-12,São Paulo,4946,1209858,16,34947,47752,3926317,2042,1671242,1174927,4853,-16
444,2021-06-13,São Paulo,0,1209858,33,34980,9720,3936037,435,1671677,1174911,-16,-33
445,2021-06-14,São Paulo,2767,1212625,59,35039,38236,3974273,2135,1673812,1177645,2734,-59
446,2021-06-15,São Paulo,5820,1218445,67,35106,68139,4042412,4006,1677818,1183406,5761,-67
447,2021-06-16,São Paulo,5263,1223708,107,35213,90693,4133105,3494,1681312,1188602,5196,-107
448,2021-06-17,São Paulo,5240,1228948,221,35434,119969,4253074,3190,1684502,1193735,5133,-221
449,2021-06-18,São Paulo,8528,1237476,116,35550,117513,4370587,3200,1687702,1202042,8307,-116
450,2021-06-19,São Paulo,924,1238400,37,35587,136768,4507355,2630,1690332,1202850,808,-37
451,2021-06-20,São Paulo,0,1238400,19,35606,66333,4573688,993,1691325,1202813,-37,-19
452,2021-06-21,São Paulo,6881,1245281,98,35704,40649,4614337,1036,1692361,1209675,6862,-98
453,2021-06-22,São Paulo,5418,1250699,22,35726,47350,4661687,2316,1694677,1214995,5320,-22
454,2021-06-23,São Paulo,5281,1255980,29,35755,70772,4732459,3603,1698280,1220254,5259,-29
455,2021-06-24,São Paulo,3928,1259908,151,35906,94146,4826605,4659,1702939,1224153,3899,-151
456,2021-06-25,São Paulo,4243,1264151,131,36037,106896,4933501,2645,1705584,1228245,4092,-131
