,DATE,REGION,NEW_CASES,CUMULATIVE_CASES,NEW_DEATHS,CUMULATIVE_DEATHS,NEW_FIRST_DOSES,CUMULATIVE_FIRST_DOSES,NEW_SECOND_DOSES,CUMULATIVE_SECOND_DOSES,CUMULATIVE_RECOVERED,NEW_RECOVERED,ACTIVE_CASES
0,2020-03-26,São Paulo,0,565,0,50,0,0,0,0,0,0,515
1,2020-03-27,São Paulo,0,565,0,50,0,0,0,0,0,0,515
2,2020-03-28,São Paulo,0,565,13,63,0,0,0,0,0,0,502
3,2020-03-29,São Paulo,0,565,13,76,0,0,0,0,0,0,489
4,2020-03-30,São Paulo,28,593,24,100,0,0,0,0,0,0,493
5,2020-03-31,São Paulo,845,1438,18,118,0,0,0,0,0,0,1320
6,2020-04-01,São Paulo,65,1503,23,141,0,0,0,0,0,0,1362
7,2020-04-02,São Paulo,17,1520,24,165,0,0,0,0,0,0,1355
8,2020-04-03,São Paulo,801,2321,48,213,0,0,0,0,0,0,2108
9,2020-04-04,São Paulo,408,2729,0,213,0,0,0,0,0,0,2516
10,2020-04-05,São Paulo,883,3612,6,219,0,0,0,0,0,0,3393
11,2020-04-06,São Paulo,142,3754,25,244,0,0,0,0,0,0,3510
12,2020-04-07,São Paulo,749,4503,53,297,0,0,0,0,0,0,4206
13,2020-04-08,São Paulo,634,5137,44,341,0,0,0,0,0,0,4796
14,2020-04-09,São Paulo,695,5832,45,386,0,0,0,0,515,515,4931
15,2020-04-10,São Paulo,547,6379,26,412,0,0,0,0,515,0,5452
16,2020-04-11,São Paulo,206,6585,10,422,0,0,0,0,502,-13,5661
17,2020-04-12,São Paulo,220,6805,23,445,0,0,0,0,489,-13,5871
18,2020-04-13,São Paulo,26,6831,11,456,0,0,0,0,493,4,5882
19,2020-04-14,São Paulo,162,6993,64,520,0,0,0,0,1320,827,5153
20,2020-04-15,São Paulo,1031,8024,43,563,0,0,0,0,1362,42,6099
21,2020-04-16,São Paulo,865,8889,47,610,0,0,0,0,1355,-7,6924
22,2020-04-17,São Paulo,468,9357,133,743,0,0,0,0,2108,753,6506
23,2020-04-18,São Paulo,770,10127,64,807,0,0,0,0,2516,408,6804
24,2020-04-19,São Paulo,261,10388,40,847,0,0,0,0,3393,877,6148
25,2020-04-20,São Paulo,236,10624,49,896,0,0,0,0,3510,117,6218
26,2020-04-21,São Paulo,641,11265,23,919,0,0,0,0,4206,696,6140
27,2020-04-22,São Paulo,118,11383,0,919,0,0,0,0,4796,590,5668
28,2020-04-23,São Paulo,0,11383,205,1124,0,0,0,0,5446,650,4813
29,2020-04-24,São Paulo,819,12202,0,1124,0,0,0,0,5967,521,5111
30,2020-04-25,São Paulo,1303,13505,29,1153,0,0,0,0,6163,196,6189
31,2020-04-26,São Paulo,469,13974,57,1210,0,0,0,0,6360,197,6404
32,2020-04-27,São Paulo,130,14104,62,1272,0,0,0,0,6375,15,6457
33,2020-04-28,São Paulo,1109,15213,65,1337,0,0,0,0,6473,98,7403
34,2020-04-29,São Paulo,712,15925,81,1418,0,0,0,0,7461,988,7046
35,2020-04-30,São Paulo,2513,18438,96,1514,0,0,0,0,8279,818,8645
36,2020-05-01,São Paulo,1241,19679,151,1665,0,0,0,0,8614,335,9400
37,2020-05-02,São Paulo,218,19897,48,1713,0,0,0,0,9320,706,8864
38,2020-05-03,São Paulo,567,20464,31,1744,0,0,0,0,9541,221,9179
39,2020-05-04,São Paulo,384,20848,31,1775,0,0,0,0,9728,187,9345
40,2020-05-05,São Paulo,1401,22249,57,1832,0,0,0,0,10346,618,10071
41,2020-05-06,São Paulo,1558,23807,96,1928,0,0,0,0,10464,118,11415
42,2020-05-07,São Paulo,1236,25043,78,2006,0,0,0,0,10259,-205,12778
43,2020-05-08,São Paulo,1230,26273,100,2106,0,0,0,0,11078,819,13089
44,2020-05-09,São Paulo,1141,27414,81,2187,0,0,0,0,12352,1274,12875
45,2020-05-10,São Paulo,613,28027,81,2268,0,0,0,0,12764,412,12995
46,2020-05-11,São Paulo,62,28089,37,2305,0,0,0,0,12832,68,12952
47,2020-05-12,São Paulo,2368,30457,125,2430,0,0,0,0,13876,1044,14151
48,2020-05-13,São Paulo,1915,32372,112,2542,0,0,0,0,14507,631,15323
49,2020-05-14,São Paulo,1469,33841,60,2602,0,0,0,0,16924,2417,14315
50,2020-05-15,São Paulo,3265,37106,79,2681,0,0,0,0,18014,1090,16411
51,2020-05-16,São Paulo,1373,38479,85,2766,0,0,0,0,18184,170,17529
52,2020-05-17,São Paulo,126,38605,66,2832,0,0,0,0,18720,536,17053
53,2020-05-18,São Paulo,558,39163,13,2845,0,0,0,0,19073,353,17245
54,2020-05-19,São Paulo,1587,40750,95,2940,0,0,0,0,20417,1344,17393
55,2020-05-20,São Paulo,1667,42417,147,3087,0,0,0,0,21879,1462,17451
56,2020-05-21,São Paulo,2099,44516,99,3186,0,0,0,0,23037,1158,18293
57,2020-05-22,São Paulo,1699,46215,69,3255,0,0,0,0,24167,1130,18793
58,2020-05-23,São Paulo,2313,48528,61,3316,0,0,0,0,25227,1060,19985
59,2020-05-24,São Paulo,778,49306,35,3351,0,0,0,0,25759,532,20196
60,2020-05-25,São Paulo,290,49596,39,3390,0,0,0,0,25784,25,20422
61,2020-05-26,São Paulo,2256,51852,31,3421,0,0,0,0,28027,2243,20404
62,2020-05-27,São Paulo,3096,54948,198,3619,0,0,0,0,29830,1803,21499
63,2020-05-28,São Paulo,1827,56775,100,3719,0,0,0,0,31239,1409,21817
64,2020-05-29,São Paulo,3094,59869,104,3823,0,0,0,0,34425,3186,21621
65,2020-05-30,São Paulo,3760,63629,329,4152,0,0,0,0,35713,1288,23764
66,2020-05-31,São Paulo,1409,65038,60,4212,0,0,0,0,35773,60,25053
67,2020-06-01,São Paulo,678,65716,29,4241,0,0,0,0,36318,545,25157
68,2020-06-02,São Paulo,3282,68998,64,4305,0,0,0,0,37810,1492,26883
69,2020-06-03,São Paulo,3173,72171,175,4480,0,0,0,0,39330,1520,28361
70,2020-06-04,São Paulo,1042,73213,88,4568,0,0,0,0,41330,2000,27315
71,2020-06-05,São Paulo,4555,77768,120,4688,0,0,0,0,42960,1630,30120
72,2020-06-06,São Paulo,2112,79880,82,4770,0,0,0,0,45212,2252,29898
73,2020-06-07,São Paulo,1229,81109,43,4813,0,0,0,0,45955,743,30341
74,2020-06-08,São Paulo,1070,82179,25,4838,0,0,0,0,46206,251,31135
75,2020-06-09,São Paulo,2683,84862,107,4945,0,0,0,0,48431,2225,31486
76,2020-06-10,São Paulo,1521,86383,178,5123,0,0,0,0,51329,2898,29931
77,2020-06-11,São Paulo,2766,89149,83,5206,0,0,0,0,53056,1727,30887
78,2020-06-12,São Paulo,3021,92170,46,5252,0,0,0,0,56046,2990,30872
79,2020-06-13,São Paulo,2672,94842,114,5366,0,0,0,0,59477,3431,29999
80,2020-06-14,São Paulo,2403,97245,62,5428,0,0,0,0,60826,1349,30991
81,2020-06-15,São Paulo,3382,100627,46,5474,0,0,0,0,61475,649,33678
82,2020-06-16,São Paulo,5031,105658,298,5772,0,0,0,0,64693,3218,35193
83,2020-06-17,São Paulo,3534,109192,170,5942,0,0,0,0,67691,2998,35559
84,2020-06-18,São Paulo,0,109192,205,6147,0,0,0,0,68645,954,34400
85,2020-06-19,São Paulo,0,109192,68,6215,0,0,0,0,73080,4435,29897
86,2020-06-20,São Paulo,8576,117768,103,6318,0,0,0,0,75110,2030,36340
87,2020-06-21,São Paulo,940,118708,65,6383,0,0,0,0,76296,1186,36029
88,2020-06-22,São Paulo,0,118708,71,6454,0,0,0,0,77341,1045,34913
89,2020-06-23,São Paulo,641,119349,153,6607,0,0,0,0,79917,2576,32825
90,2020-06-24,São Paulo,18990,138339,115,6722,0,0,0,0,81260,1343,50357
91,2020-06-25,São Paulo,4411,142750,70,6792,0,0,0,0,83943,2683,52015
92,2020-06-26,São Paulo,4366,147116,74,6866,0,0,0,0,86918,2975,53332
93,2020-06-27,São Paulo,420,147536,54,6920,0,0,0,0,89476,2558,51140
94,2020-06-28,São Paulo,3221,150757,25,6945,0,0,0,0,91817,2341,51995
95,2020-06-29,São Paulo,153,150910,37,6982,0,0,0,0,95153,3336,48775
96,2020-06-30,São Paulo,504,151414,141,7123,0,0,0,0,99886,4733,44405
97,2020-07-01,São Paulo,8923,160337,204,7327,0,0,0,0,103250,3364,49760
98,2020-07-02,São Paulo,2849,163186,91,7418,0,0,0,0,103045,-205,52723
99,2020-07-03,São Paulo,2380,165566,67,7485,0,0,0,0,102977,-68,55104
100,2020-07-04,São Paulo,2822,168388,43,7528,0,0,0,0,111450,8473,49410
101,2020-07-05,São Paulo,1954,170342,46,7574,0,0,0,0,112325,875,50443
102,2020-07-06,São Paulo,827,171169,34,7608,0,0,0,0,112254,-71,51307
103,2020-07-07,São Paulo,2411,173580,131,7739,0,0,0,0,112742,488,53099
104,2020-07-08,São Paulo,2723,176303,150,7889,0,0,0,0,131617,18875,36797
105,2020-07-09,São Paulo,1815,178118,98,7987,0,0,0,0,135958,4341,34173
106,2020-07-10,São Paulo,313,178431,85,8072,0,0,0,0,140250,4292,30109
107,2020-07-11,São Paulo,350,178781,74,8146,0,0,0,0,140616,366,30019
108,2020-07-12,São Paulo,118,178899,42,8188,0,0,0,0,143812,3196,26899
109,2020-07-13,São Paulo,98,178997,30,8218,0,0,0,0,143928,116,26851
110,2020-07-14,São Paulo,404,179401,225,8443,0,0,0,0,144291,363,26667
111,2020-07-15,São Paulo,449,179850,131,8574,0,0,0,0,153010,8719,18266
112,2020-07-16,São Paulo,600,180450,134,8708,0,0,0,0,155768,2758,15974
113,2020-07-17,São Paulo,306,180756,51,8759,0,0,0,0,158081,2313,13916
114,2020-07-18,São Paulo,319,181075,0,8759,0,0,0,0,160860,2779,11456
115,2020-07-19,São Paulo,83,181158,0,8759,0,0,0,0,162768,1908,9631
116,2020-07-20,São Paulo,120,181278,0,8759,0,0,0,0,163561,793,8958
117,2020-07-21,São Paulo,491,181769,277,9036,0,0,0,0,165841,2280,6892
118,2020-07-22,São Paulo,18601,200370,0,9036,0,0,0,0,168414,2573,22920
119,2020-07-23,São Paulo,2201,202571,220,9256,0,0,0,0,170131,1717,23184
120,2020-07-24,São Paulo,737,203308,77,9333,0,0,0,0,170359,228,23616
121,2020-07-25,São Paulo,4436,207744,70,9403,0,0,0,0,170635,276,27706
122,2020-07-26,São Paulo,0,207744,0,9403,0,0,0,0,170711,76,27630
123,2020-07-27,São Paulo,189,207933,0,9403,0,0,0,0,170779,68,27751
124,2020-07-28,São Paulo,5503,213436,137,9540,0,0,0,0,170958,179,32938
125,2020-07-29,São Paulo,6858,220294,121,9661,0,0,0,0,171276,318,39357
126,2020-07-30,São Paulo,3277,223571,49,9710,0,0,0,0,171742,466,42119
127,2020-07-31,São Paulo,2016,225587,42,9752,0,0,0,0,171997,255,43838
128,2020-08-01,São Paulo,4728,230315,82,9834,0,0,0,0,172316,319,48165
129,2020-08-02,São Paulo,60,230375,29,9863,0,0,0,0,172399,83,48113
130,2020-08-03,São Paulo,37,230412,20,9883,0,0,0,0,172519,120,48010
131,2020-08-04,São Paulo,3051,233463,59,9942,0,0,0,0,172733,214,50788
132,2020-08-05,São Paulo,2715,236178,113,10055,0,0,0,0,191334,18601,34789
133,2020-08-06,São Paulo,6592,242770,104,10159,0,0,0,0,193315,1981,39296
134,2020-08-07,São Paulo,1561,244331,87,10246,0,0,0,0,193975,660,40110
135,2020-08-08,São Paulo,2319,246650,57,10303,0,0,0,0,198341,4366,38006
136,2020-08-09,São Paulo,80,246730,20,10323,0,0,0,0,198341,0,38066
137,2020-08-10,São Paulo,57,246787,16,10339,0,0,0,0,198530,189,37918
138,2020-08-11,São Paulo,2963,249750,134,10473,0,0,0,0,203896,5366,35381
139,2020-08-12,São Paulo,8731,258481,140,10613,0,0,0,0,210633,6737,37235
140,2020-08-13,São Paulo,8758,267239,62,10675,0,0,0,0,213861,3228,42703
141,2020-08-14,São Paulo,2595,269834,83,10758,0,0,0,0,215835,1974,43241
142,2020-08-15,São Paulo,1598,271432,51,10809,0,0,0,0,220481,4646,40142
143,2020-08-16,São Paulo,638,272070,17,10826,0,0,0,0,220512,31,40732
144,2020-08-17,São Paulo,363,272433,34,10860,0,0,0,0,220529,17,41044
145,2020-08-18,São Paulo,814,273247,35,10895,0,0,0,0,223521,2992,38831
146,2020-08-19,São Paulo,2287,275534,174,11069,0,0,0,0,226123,2602,38342
147,2020-08-20,São Paulo,1916,277450,146,11215,0,0,0,0,232611,6488,33624
148,2020-08-21,São Paulo,1120,278570,214,11429,0,0,0,0,234085,1474,33056
149,2020-08-22,São Paulo,4191,282761,2,11431,0,0,0,0,236347,2262,34983
150,2020-08-23,São Paulo,1309,284070,23,11454,0,0,0,0,236407,60,36209
151,2020-08-24,São Paulo,101,284171,25,11479,0,0,0,0,236448,41,36244
152,2020-08-25,São Paulo,2808,286979,94,11573,0,0,0,0,239277,2829,36129
153,2020-08-26,São Paulo,2085,289064,250,11823,0,0,0,0,247868,8591,29373
154,2020-08-27,São Paulo,2689,291753,110,11933,0,0,0,0,256564,8696,23256
155,2020-08-28,São Paulo,2001,293754,52,11985,0,0,0,0,259076,2512,22693
156,2020-08-29,São Paulo,1226,294980,24,12009,0,0,0,0,260623,1547,22348
157,2020-08-30,São Paulo,270,295250,44,12053,0,0,0,0,261244,621,21953
158,2020-08-31,São Paulo,185,295435,7,12060,0,0,0,0,261573,329,21802
159,2020-09-01,São Paulo,3263,298698,83,12143,0,0,0,0,262352,779,24203
160,2020-09-02,São Paulo,2145,300843,133,12276,0,0,0,0,264465,2113,24102
161,2020-09-03,São Paulo,2391,303234,120,12396,0,0,0,0,266235,1770,24603
162,2020-09-04,São Paulo,1520,304754,162,12558,0,0,0,0,267141,906,25055
163,2020-09-05,São Paulo,1288,306042,27,12585,0,0,0,0,271330,4189,22127
164,2020-09-06,São Paulo,319,306361,0,12585,0,0,0,0,272616,1286,21160
165,2020-09-07,São Paulo,168,306529,10,12595,0,0,0,0,272692,76,21242
166,2020-09-08,São Paulo,480,307009,0,12595,0,0,0,0,275406,2714,19008
167,2020-09-09,São Paulo,1831,308840,67,12662,0,0,0,0,277241,1835,18937
168,2020-09-10,São Paulo,1649,310489,105,12767,0,0,0,0,279820,2579,17902
169,2020-09-11,São Paulo,1600,312089,36,12803,0,0,0,0,281769,1949,17517
170,2020-09-12,São Paulo,1462,313551,14,12817,0,0,0,0,282971,1202,17763
171,2020-09-13,São Paulo,307,313858,33,12850,0,0,0,0,283197,226,17811
172,2020-09-14,São Paulo,0,313858,12,12862,0,0,0,0,283375,178,17621
173,2020-09-15,São Paulo,2018,315876,68,12930,0,0,0,0,286555,3180,16391
174,2020-09-16,São Paulo,1527,317403,181,13111,0,0,0,0,288567,2012,15725
175,2020-09-17,São Paulo,1565,318968,55,13166,0,0,0,0,290838,2271,14964
176,2020-09-18,São Paulo,1709,320677,78,13244,0,0,0,0,292196,1358,15237
177,2020-09-19,São Paulo,254,320931,35,13279,0,0,0,0,293457,1261,14195
178,2020-09-20,São Paulo,30,320961,43,13322,0,0,0,0,293776,319,13863
179,2020-09-21,São Paulo,52,321013,17,13339,0,0,0,0,293934,158,13740
180,2020-09-22,São Paulo,348,321361,26,13365,0,0,0,0,294414,480,13582
181,2020-09-23,São Paulo,272,321633,98,13463,0,0,0,0,296178,1764,11992
182,2020-09-24,São Paulo,218,321851,64,13527,0,0,0,0,297722,1544,10602
183,2020-09-25,São Paulo,6426,328277,34,13561,0,0,0,0,299286,1564,15430
184,2020-09-26,São Paulo,1156,329433,9,13570,0,0,0,0,300734,1448,15129
185,2020-09-27,São Paulo,271,329704,0,13570,0,0,0,0,301008,274,15126
186,2020-09-28,São Paulo,399,330103,10,13580,0,0,0,0,300996,-12,15527
187,2020-09-29,São Paulo,1419,331522,105,13685,0,0,0,0,302946,1950,14891
188,2020-09-30,São Paulo,1428,332950,18,13703,0,0,0,0,304292,1346,14955
189,2020-10-01,São Paulo,1227,334177,19,13722,0,0,0,0,305802,1510,14653
190,2020-10-02,São Paulo,1153,335330,20,13742,0,0,0,0,307433,1631,14155
191,2020-10-03,São Paulo,1440,336770,1,13743,0,0,0,0,307652,219,15375
192,2020-10-04,São Paulo,303,337073,0,13743,0,0,0,0,307639,-13,15691
193,2020-10-05,São Paulo,133,337206,78,13821,0,0,0,0,307674,35,15711
194,2020-10-06,São Paulo,0,337206,51,13872,0,0,0,0,307996,322,15338
195,2020-10-07,São Paulo,2571,339777,130,14002,0,0,0,0,308170,174,17605
196,2020-10-08,São Paulo,965,340742,40,14042,0,0,0,0,308324,154,18376
197,2020-10-09,São Paulo,1603,342345,0,14042,0,0,0,0,314716,6392,13587
198,2020-10-10,São Paulo,1229,343574,36,14078,0,0,0,0,315863,1147,13633
199,2020-10-11,São Paulo,318,343892,12,14090,0,0,0,0,316134,271,13668
200,2020-10-12,São Paulo,145,344037,0,14090,0,0,0,0,316523,389,13424
201,2020-10-13,São Paulo,211,344248,0,14090,0,0,0,0,317837,1314,12321
202,2020-10-14,São Paulo,1247,345495,48,14138,0,0,0,0,319247,1410,12110
203,2020-10-15,São Paulo,1523,347018,40,14178,0,0,0,0,320455,1208,12385
204,2020-10-16,São Paulo,1360,348378,21,14199,0,0,0,0,321588,1133,12591
205,2020-10-17,São Paulo,201,348579,25,14224,0,0,0,0,323027,1439,11328
206,2020-10-18,São Paulo,1111,349690,1,14225,0,0,0,0,323330,303,12135
207,2020-10-19,São Paulo,1021,350711,20,14245,0,0,0,0,323385,55,13081
208,2020-10-20,São Paulo,1166,351877,8,14253,0,0,0,0,323334,-51,14290
209,2020-10-21,São Paulo,1076,352953,31,14284,0,0,0,0,325775,2441,12894
210,2020-10-22,São Paulo,999,353952,9,14293,0,0,0,0,326700,925,12959
211,2020-10-23,São Paulo,1784,355736,22,14315,0,0,0,0,328303,1603,13118
212,2020-10-24,São Paulo,1440,357176,3,14318,0,0,0,0,329496,1193,13362
213,2020-10-25,São Paulo,410,357586,7,14325,0,0,0,0,329802,306,13459
214,2020-10-26,São Paulo,163,357749,15,14340,0,0,0,0,329947,145,13462
215,2020-10-27,São Paulo,1767,359516,3,14343,0,0,0,0,330158,211,15015
216,2020-10-28,São Paulo,1550,361066,34,14377,0,0,0,0,331357,1199,15332
217,2020-10-29,São Paulo,1399,362465,6,14383,0,0,0,0,332840,1483,15242
218,2020-10-30,São Paulo,1398,363863,15,14398,0,0,0,0,334179,1339,15286
219,2020-10-31,São Paulo,788,364651,0,14398,0,0,0,0,334355,176,15898
220,2020-11-01,São Paulo,23,364674,0,14398,0,0,0,0,335465,1110,14811
221,2020-11-02,São Paulo,390,365064,0,14398,0,0,0,0,336466,1001,14200
222,2020-11-03,São Paulo,297,365361,104,14502,0,0,0,0,337624,1158,13235
223,2020-11-04,São Paulo,1119,366480,43,14545,0,0,0,0,338669,1045,13266
224,2020-11-05,São Paulo,1121,367601,27,14572,0,0,0,0,339659,990,13370
225,2020-11-06,São Paulo,0,367601,2,14574,0,0,0,0,341421,1762,11606
226,2020-11-07,São Paulo,0,367601,7,14581,0,0,0,0,342858,1437,10162
227,2020-11-08,São Paulo,0,367601,15,14596,0,0,0,0,343261,403,9744
228,2020-11-09,São Paulo,0,367601,18,14614,0,0,0,0,343409,148,9578
229,2020-11-10,São Paulo,6453,374054,52,14666,0,0,0,0,345173,1764,14215
230,2020-11-11,São Paulo,2227,376281,31,14697,0,0,0,0,346689,1516,14895
231,2020-11-12,São Paulo,1879,378160,12,14709,0,0,0,0,348082,1393,15369
232,2020-11-13,São Paulo,0,378160,4,14713,0,0,0,0,349465,1383,13982
233,2020-11-14,São Paulo,4028,382188,10,14723,0,0,0,0,350253,788,17212
234,2020-11-15,São Paulo,393,382581,10,14733,0,0,0,0,350276,23,17572
235,2020-11-16,São Paulo,220,382801,35,14768,0,0,0,0,350666,390,17367
236,2020-11-17,São Paulo,2415,385216,12,14780,0,0,0,0,350859,193,19577
237,2020-11-18,São Paulo,2012,387228,40,14820,0,0,0,0,351935,1076,20473
238,2020-11-19,São Paulo,2481,389709,14,14834,0,0,0,0,353029,1094,21846
239,2020-11-20,São Paulo,2574,392283,21,14855,0,0,0,0,353027,-2,24401
240,2020-11-21,São Paulo,1784,394067,8,14863,0,0,0,0,353020,-7,26184
241,2020-11-22,São Paulo,709,394776,13,14876,0,0,0,0,353005,-15,26895
242,2020-11-23,São Paulo,125,394901,38,14914,0,0,0,0,352987,-18,27000
243,2020-11-24,São Paulo,1813,396714,100,15014,0,0,0,0,359388,6401,22312
244,2020-11-25,São Paulo,2668,399382,48,15062,0,0,0,0,361584,2196,22736
245,2020-11-26,São Paulo,1334,400716,20,15082,0,0,0,0,363451,1867,22183
246,2020-11-27,São Paulo,1052,401768,34,15116,0,0,0,0,363447,-4,23205
247,2020-11-28,São Paulo,4594,406362,12,15128,0,0,0,0,367465,4018,23769
248,2020-11-29,São Paulo,541,406903,2,15130,0,0,0,0,367848,383,23925
249,2020-11-30,São Paulo,223,407126,20,15150,0,0,0,0,368033,185,23943
250,2020-12-01,São Paulo,2707,409833,43,15193,0,0,0,0,370436,2403,24204
251,2020-12-02,São Paulo,6049,415882,54,15247,0,0,0,0,372408,1972,28227
252,2020-12-03,São Paulo,2320,418202,42,15289,0,0,0,0,374875,2467,28038
253,2020-12-04,São Paulo,2401,420603,40,15329,0,0,0,0,377428,2553,27846
254,2020-12-05,São Paulo,2418,423021,18,15347,0,0,0,0,379204,1776,28470
255,2020-12-06,São Paulo,754,423775,26,15373,0,0,0,0,379900,696,28502
256,2020-12-07,São Paulo,225,424000,28,15401,0,0,0,0,379987,87,28612
257,2020-12-08,São Paulo,2439,426439,37,15438,0,0,0,0,381700,1713,29301
258,2020-12-09,São Paulo,2795,429234,67,15505,0,0,0,0,384320,2620,29409
259,2020-12-10,São Paulo,14461,443695,48,15553,0,0,0,0,385634,1314,42508
260,2020-12-11,São Paulo,2644,446339,45,15598,0,0,0,0,386652,1018,44089
261,2020-12-12,São Paulo,2096,448435,9,15607,0,0,0,0,391234,4582,41594
262,2020-12-13,São Paulo,254,448689,19,15626,0,0,0,0,391773,539,41290
263,2020-12-14,São Paulo,466,449155,50,15676,0,0,0,0,391976,203,41503
264,2020-12-15,São Paulo,1113,450268,25,15701,0,0,0,0,394640,2664,39927
265,2020-12-16,São Paulo,3481,453749,80,15781,0,0,0,0,400635,5995,37333
266,2020-12-17,São Paulo,2823,456572,30,15811,0,0,0,0,402913,2278,37848
267,2020-12-18,São Paulo,2674,459246,43,15854,0,0,0,0,405274,2361,38118
268,2020-12-19,São Paulo,2420,461666,26,15880,0,0,0,0,407674,2400,38112
269,2020-12-20,São Paulo,818,462484,14,15894,0,0,0,0,408402,728,38188
270,2020-12-21,São Paulo,443,462927,17,15911,0,0,0,0,408599,197,38417
271,2020-12-22,São Paulo,3037,465964,35,15946,0,0,0,0,411001,2402,39017
272,2020-12-23,São Paulo,3025,468989,13,15959,0,0,0,0,413729,2728,39301
273,2020-12-24,São Paulo,0,468989,83,16042,0,0,0,0,428142,14413,24805
274,2020-12-25,São Paulo,0,468989,33,16075,0,0,0,0,430741,2599,22173
275,2020-12-26,São Paulo,4542,473531,9,16084,0,0,0,0,432828,2087,24619
276,2020-12-27,São Paulo,789,474320,5,16089,0,0,0,0,433063,235,25168
277,2020-12-28,São Paulo,626,474946,3,16092,0,0,0,0,433479,416,25375
278,2020-12-29,São Paulo,3884,478830,71,16163,0,0,0,0,434567,1088,28100
279,2020-12-30,São Paulo,3722,482552,218,16381,0,0,0,0,437968,3401,28203
280,2020-12-31,São Paulo,0,482522,2,16383,0,0,0,0,440761,2793,25378
281,2021-01-01,São Paulo,0,482522,25,16408,0,0,0,0,443392,2631,22722
282,2021-01-02,São Paulo,4717,487239,49,16457,0,0,0,0,445786,2394,24996
283,2021-01-03,São Paulo,988,488227,6,16463,0,0,0,0,446590,804,25174
284,2021-01-04,São Paulo,427,488654,1,16464,0,0,0,0,447016,426,25174
285,2021-01-05,São Paulo,3424,492078,1,16465,0,0,0,0,450018,3002,25595
286,2021-01-06,São Paulo,3683,495761,90,16555,0,0,0,0,453030,3012,26176
287,2021-01-07,São Paulo,3515,499276,171,16726,0,0,0,0,452947,-83,29603
288,2021-01-08,São Paulo,4653,503929,82,16808,0,0,0,0,452914,-33,34207
289,2021-01-09,São Paulo,3231,507160,28,16836,0,0,0,0,457447,4533,32877
290,2021-01-10,São Paulo,1086,508246,45,16881,0,0,0,0,458231,784,33134
291,2021-01-11,São Paulo,779,509025,25,16906,0,0,0,0,458854,623,33265
292,2021-01-12,São Paulo,2480,511505,84,16990,0,0,0,0,462667,3813,31848
293,2021-01-13,São Paulo,4274,515779,117,17107,0,0,0,0,466171,3504,32501
294,2021-01-14,São Paulo,3597,519376,66,17173,0,0,0,0,466139,-32,36064
295,2021-01-15,São Paulo,3991,523367,54,17227,0,0,0,0,466114,-25,40026
296,2021-01-16,São Paulo,3530,526897,17,17244,0,0,0,0,470782,4668,38871
297,2021-01-17,São Paulo,1159,528056,37,17281,0,0,0,0,471764,982,39011
298,2021-01-18,São Paulo,753,528809,34,17315,0,0,0,0,472190,426,39304
299,2021-01-19,São Paulo,4410,533219,54,17369,0,0,0,0,475613,3423,40237
300,2021-01-20,São Paulo,3894,537113,124,17493,0,0,0,0,479206,3593,40414
301,2021-01-21,São Paulo,3505,540618,79,17572,0,0,0,0,482550,3344,40496
302,2021-01-22,São Paulo,2142,542760,184,17756,0,0,0,0,487121,4571,37883
303,2021-01-23,São Paulo,3763,546523,0,17756,0,0,0,0,490324,3203,38443
304,2021-01-24,São Paulo,1135,547658,0,17756,0,0,0,0,491365,1041,38537
305,2021-01-25,São Paulo,578,548236,0,17756,0,0,0,0,492119,754,38361
306,2021-01-26,São Paulo,1550,549786,67,17823,0,0,0,0,494515,2396,37448
307,2021-01-27,São Paulo,4081,553867,95,17918,0,0,0,0,498672,4157,37277
308,2021-01-28,São Paulo,4138,558005,144,18062,0,0,0,0,502203,3531,37740
309,2021-01-29,São Paulo,3974,561979,55,18117,0,0,0,0,506140,3937,37722
310,2021-01-30,São Paulo,2740,564719,30,18147,0,0,0,0,509653,3513,36919
311,2021-01-31,São Paulo,813,565532,1,18148,0,0,0,0,510775,1122,36609
312,2021-02-01,São Paulo,614,566146,92,18240,0,0,0,0,511494,719,36412
313,2021-02-02,São Paulo,4266,570412,44,18284,0,0,0,0,515850,4356,36278
314,2021-02-03,São Paulo,3486,573898,83,18367,0,0,0,0,519620,3770,35911
315,2021-02-04,São Paulo,4326,578224,106,18473,0,0,0,0,523046,3426,36705
316,2021-02-05,São Paulo,3016,581240,97,18570,0,0,0,0,525004,1958,37666
317,2021-02-06,São Paulo,2981,584221,78,18648,0,0,0,0,528767,3763,36806
318,2021-02-07,São Paulo,959,585180,2,18650,0,0,0,0,529902,1135,36628
319,2021-02-08,São Paulo,585,585765,53,18703,0,0,0,0,530480,578,36582
320,2021-02-09,São Paulo,3399,589164,75,18778,0,0,0,0,531963,1483,38423
321,2021-02-10,São Paulo,3326,592490,112,18890,0,0,0,0,535949,3986,37651
322,2021-02-11,São Paulo,5274,597764,51,18941,0,0,0,0,539943,3994,38880
323,2021-02-12,São Paulo,5618,603382,78,19019,0,0,0,0,543862,3919,40501
324,2021-02-13,São Paulo,2882,606264,49,19068,0,0,0,0,546572,2710,40624
325,2021-02-14,São Paulo,2734,608998,14,19082,0,0,0,0,547384,812,42532
326,2021-02-15,São Paulo,2741,611739,47,19129,0,0,0,0,547906,522,44704
327,2021-02-16,São Paulo,2913,614652,15,19144,0,0,0,0,552128,4222,43380
328,2021-02-17,São Paulo,3109,617761,115,19259,0,0,0,0,555531,3403,42971
329,2021-02-18,São Paulo,15354,633115,33,19292,0,0,0,0,559751,4220,54072
330,2021-02-19,São Paulo,5384,638499,53,19345,0,0,0,0,562670,2919,56484
331,2021-02-20,São Paulo,5149,643648,10,19355,0,0,0,0,565573,2903,58720
332,2021-02-21,São Paulo,3562,647210,40,19395,0,758,0,0,566530,957,61285
333,2021-02-22,São Paulo,3352,650562,0,19382,0,9600,0,0,567062,532,64118
334,2021-02-23,São Paulo,5479,656041,74,19456,0,9531,0,0,570386,3324,66199
335,2021-02-24,São Paulo,5779,661820,103,19559,0,6820,0,0,573600,3214,68661
336,2021-02-25,São Paulo,2696,664516,0,19559,0,0,0,0,578823,5223,66134
337,2021-02-26,São Paulo,8070,672586,111,19670,0,15741,0,0,584363,5540,68553
338,2021-02-27,São Paulo,4970,677556,6,19676,0,0,0,0,587196,2833,70684
339,2021-02-28,São Paulo,2696,680252,2,19678,0,5941,0,0,589916,2720,70658
340,2021-03-01,São Paulo,4367,684619,312,19990,0,5175,0,0,592610,2694,72019
341,2021-03-02,São Paulo,5270,689889,44,20034,0,12513,0,0,595508,2898,74347
342,2021-03-03,São Paulo,5824,695713,107,20141,0,9078,0,0,598502,2994,77070
343,2021-03-04,São Paulo,6074,701787,90,20231,0,11619,0,0,613823,15321,67733
344,2021-03-05,São Paulo,5911,707698,77,20308,0,17293,0,0,619154,5331,68236
345,2021-03-06,São Paulo,5530,713228,12,20320,0,9292,0,0,624293,5139,68615
346,2021-03-07,São Paulo,4240,717468,55,20375,0,1384,0,0,627815,3522,69278
347,2021-03-08,São Paulo,3859,721327,28,20403,0,10326,0,0,631180,3365,69744
348,2021-03-09,São Paulo,5984,727311,94,20497,0,10369,0,0,636585,5405,70229
349,2021-03-10,São Paulo,6629,733940,76,20573,0,11467,0,0,642261,5676,71106
350,2021-03-11,São Paulo,5890,739830,91,20664,0,12455,0,0,644957,2696,74209
351,2021-03-12,São Paulo,5132,744962,79,20743,0,15022,0,0,652916,7959,71303
352,2021-03-13,São Paulo,6447,751409,45,20788,0,5753,0,0,657880,4964,72741
353,2021-03-14,São Paulo,4741,756150,65,20853,0,959,0,0,660574,2694,74723
354,2021-03-15,São Paulo,4185,760335,171,21024,0,6257,0,0,664629,4055,74682
355,2021-03-16,São Paulo,4772,765107,109,21133,0,9024,0,0,669855,5226,74119
356,2021-03-17,São Paulo,6362,771469,240,21373,0,8701,0,0,675572,5717,74524
357,2021-03-18,São Paulo,5913,777382,3,21376,0,8150,0,0,681556,5984,74450
358,2021-03-19,São Paulo,5828,783210,241,21617,0,5744,0,0,687390,5834,74203
359,2021-03-20,São Paulo,5562,788772,188,21805,0,3273,0,0,692908,5518,74059
360,2021-03-21,São Paulo,2696,791468,57,21862,0,336,0,0,697093,4185,72513
361,2021-03-22,São Paulo,6086,797554,165,22027,0,6040,0,0,700924,3831,74603
362,2021-03-23,São Paulo,4361,801915,18,22045,0,11098,0,0,706814,5890,73056
363,2021-03-24,São Paulo,6003,807918,106,22151,0,23336,0,0,713367,6553,72400
364,2021-03-25,São Paulo,5829,813747,275,22426,0,24659,0,0,719166,5799,72155
365,2021-03-26,São Paulo,6102,819849,297,22723,0,14847,0,0,724219,5053,72907
366,2021-03-27,São Paulo,26720,846569,79,22802,0,8447,0,0,730621,6402,93146
367,2021-03-28,São Paulo,2696,849265,138,22940,0,1743,0,0,735297,4676,91028
368,2021-03-29,São Paulo,5672,854937,383,23323,0,8002,0,0,739311,4014,92303
369,2021-03-30,São Paulo,7624,862561,70,23393,0,11426,0,0,743974,4663,95194
370,2021-03-31,São Paulo,14020,876581,85,23478,0,11038,0,0,750096,6122,103007
371,2021-04-01,São Paulo,4906,749383,72,23550,18610,1332654,11152,471054,756006,5910,-30173
372,2021-04-02,São Paulo,3537,752920,32,23582,25651,1358305,5971,477025,761593,5587,-32255
373,2021-04-03,São Paulo,1510,754430,475,24057,18626,1376931,1600,478625,766967,5374,-36594
374,2021-04-04,São Paulo,1634,756064,178,24235,5826,1382757,679,479304,769606,2639,-37777
375,2021-04-05,São Paulo,1223,757287,686,24921,17575,1400332,26320,505624,775527,5921,-43161
376,2021-04-06,São Paulo,4310,761597,15,24936,31080,1431412,36670,542294,779870,4343,-43209
377,2021-04-07,São Paulo,2435,764032,398,25334,48077,1479489,32748,575042,785767,5897,-47069
378,2021-04-08,São Paulo,2198,766230,802,26136,28848,1508337,20979,596021,791321,5554,-51227
379,2021-04-09,São Paulo,708,766938,425,26561,17269,1525606,56489,652510,797126,5805,-56749
380,2021-04-10,São Paulo,633,767571,253,26814,23177,1548783,42964,695474,823767,26641,-83010
381,2021-04-11,São Paulo,0,767571,117,26931,12269,1561052,3914,699388,826325,2558,-85685
382,2021-04-12,São Paulo,211,767782,276,27207,31827,1592879,20142,719530,831614,5289,-91039
383,2021-04-13,São Paulo,934,768716,6,27213,46155,1639034,27447,746977,839168,7554,-97665
384,2021-04-14,São Paulo,2538,771254,287,27500,29139,1668173,17346,764323,853103,13935,-109349
385,2021-04-15,São Paulo,2141,773395,319,27819,20847,1689020,16588,780911,725833,-127270,19743
386,2021-04-16,São Paulo,654,774049,224,28043,15589,1704609,69898,850809,729338,3505,16668
387,2021-04-17,São Paulo,4902,778951,171,28214,9174,1713783,47769,898578,730373,1035,20364
388,2021-04-18,São Paulo,0,778951,48,28262,2010,1715793,4865,903443,731829,1456,18860
389,2021-04-19,São Paulo,186148,965099,240,28502,56904,1772697,25390,928833,732366,537,204231
390,2021-04-20,São Paulo,6487,971586,3,28505,-37455,1735242,34039,962872,736661,4295,206420
391,2021-04-21,São Paulo,5772,977358,203,28708,89833,1825075,21853,984725,738698,2037,209952
392,2021-04-22,São Paulo,3399,980757,61,28769,50653,1875728,17062,1001787,740094,1396,211894
393,2021-04-23,São Paulo,6026,986783,263,29032,48234,1923962,35593,1037380,740377,283,217374
394,2021-04-24,São Paulo,4900,991683,138,29170,32291,1956253,23913,1061293,740757,380,221756
395,2021-04-25,São Paulo,0,991683,41,29211,4133,1960386,4658,1065951,740640,-117,221832
396,2021-04-26,São Paulo,2916,994599,258,29469,0,1960386,0,1065951,740575,-65,224555
397,2021-04-27,São Paulo,6077,1000676,3,29472,33185,1993571,53111,1119062,741503,928,229701
398,2021-04-28,São Paulo,6087,1006763,204,29676,8248,2001819,26016,1145078,743754,2251,233333
399,2021-04-29,São Paulo,36500,1043263,587,30263,38702,2040521,23045,1168123,745576,1822,267424
400,2021-04-30,São Paulo,4798,1048061,187,30450,39227,2079748,21428,1189551,746006,430,271605
401,2021-05-01,São Paulo,4129,1052190,40,30490,15330,2095078,20217,1209768,750737,4731,270963
402,2021-05-02,São Paulo,0,1052190,17,30507,1859,2096937,4280,1214048,750689,-48,270994
403,2021-05-03,São Paulo,2464,1054654,202,30709,7259,2104196,25398,1239446,936597,185908,87348
404,2021-05-04,São Paulo,4658,1059312,30,30739,12624,2116820,32556,1272002,943081,6484,85492
405,2021-05-05,São Paulo,4416,1063728,33,30772,10694,2127514,31460,1303462,948650,5569,84306
406,2021-05-06,São Paulo,4252,1067980,180,30952,97002,2224516,51542,1355004,951988,3338,85040
407,2021-05-07,São Paulo,4256,1072236,142,31094,91791,2316307,14418,1369422,957751,5763,83391
408,2021-05-08,São Paulo,3366,1075602,89,31183,61318,2377625,12921,1382343,962513,4762,81906
409,2021-05-09,São Paulo,0,1075602,35,31218,14351,2391976,3537,1385880,962472,-41,81912
410,2021-05-10,São Paulo,2864,1078466,136,31354,13904,2405880,8306,1394186,965130,2658,81982
411,2021-05-11,São Paulo,5163,1083629,1,31355,27094,2432974,12063,1406249,971204,6074,81070
412,2021-05-12,São Paulo,4865,1088494,143,31498,53629,2486603,8264,1414513,977087,5883,79909
413,2021-05-13,São Paulo,4286,1092780,529,32027,51986,2538589,8975,1423488,1013000,35913,47753
414,2021-05-14,São Paulo,4706,1097486,95,32122,65192,2603781,8352,1431840,1017611,4611,47753
415,2021-05-15,São Paulo,4058,1101544,51,32173,79016,2682797,5854,1437694,1021700,4089,47671
416,2021-05-16,São Paulo,0,1101544,110,32283,27262,2710059,1592,1439286,1021683,-17,47578
417,2021-05-17,São Paulo,3653,1105197,111,32394,19328,2729387,3387,1442673,1023945,2262,48858
418,2021-05-18,São Paulo,4721,1109918,0,32394,42737,2772124,4578,1447251,1028573,4628,48951
419,2021-05-19,São Paulo,4555,1114473,158,32552,52269,2824393,4030,1451281,1032956,4383,48965
420,2021-05-20,São Paulo,4853,1119326,97,32649,53503,2877896,4596,1455877,1037028,4072,49649
421,2021-05-21,São Paulo,4483,1123809,90,32739,81852,2959748,5481,1461358,1041142,4114,49928
422,2021-05-22,São Paulo,4349,1128158,98,32837,45126,3004874,7520,1468878,1044419,3277,50902
423,2021-05-23,São Paulo,0,1128158,55,32892,5677,3010551,2647,1471525,1044384,-35,50882
424,2021-05-24,São Paulo,2752,1130910,168,33060,25924,3036475,12981,1484506,1047112,2728,50738
425,2021-05-25,São Paulo,4946,1135856,29,33089,53504,3089979,15544,1500050,1052274,5162,50493
426,2021-05-26,São Paulo,5010,1140866,82,33171,48776,3138755,15091,1515141,1056996,4722,50699
427,2021-05-27,São Paulo,2239,1143105,127,33298,43162,3181917,15303,1530444,1060753,3757,49054
428,2021-05-28,São Paulo,469,1143574,204,33502,61670,3243587,12526,1542970,1065364,4611,44708
429,2021-05-29,São Paulo,0,1143574,4,33506,68942,3312529,9731,1552701,1069371,4007,40697
430,2021-05-30,São Paulo,0,1143574,4,33510,24968,3337497,3252,1555953,1069261,-110,40803
431,2021-05-31,São Paulo,12908,1156482,38,33548,23578,3361075,6234,1562187,1072803,3542,50131
432,2021-06-01,São Paulo,5298,1161780,0,33548,46572,3407647,17098,1579285,1077524,4721,50708
433,2021-06-02,São Paulo,5363,1167143,126,33674,60755,3468402,14360,1593645,1081921,4397,51548
434,2021-06-03,São Paulo,4848,1171991,225,33899,67340,3535742,15433,1609078,1086677,4756,51415
435,2021-06-04,São Paulo,4386,1176377,263,34162,50242,3585984,13228,1622306,1091070,4393,51145
436,2021-06-05,São Paulo,4077,1180454,85,34247,49764,3635748,17087,1639393,1095321,4251,50886
437,2021-06-06,São Paulo,0,1180454,19,34266,16279,3652027,5307,1644700,1095266,-55,50922
438,2021-06-07,São Paulo,4335,1184789,74,34340,25250,3677277,4741,1649441,1097850,2584,52599
439,2021-06-08,São Paulo,4703,1189492,56,34396,49959,3727236,6704,1656145,1102767,4917,52329
440,2021-06-09,São Paulo,4255,1193747,141,34537,45800,3773036,5110,1661255,1107695,4928,51515
441,2021-06-10,São Paulo,6091,1199838,301,34838,44059,3817095,4335,1665590,1109807,2112,55193
442,2021-06-11,São Paulo,5074,1204912,93,34931,61470,3878565,3610,1669200,1110072,265,59909
443,2021-06-12,São Paulo,4946,1209858,16,34947,47752,3926317,2042,1671242,1110068,-4,64843
444,2021-06-13,São Paulo,0,1209858,33,34980,9720,3936037,435,1671677,1110064,-4,64814
445,2021-06-14,São Paulo,2767,1212625,59,35039,38236,3974273,2135,1673812,1122934,12870,54652
446,2021-06-15,São Paulo,5820,1218445,67,35106,68139,4042412,4006,1677818,1128232,5298,55107
447,2021-06-16,São Paulo,5263,1223708,107,35213,90693,4133105,3494,1681312,1133469,5237,55026
448,2021-06-17,São Paulo,5240,1228948,221,35434,119969,4253074,3190,1684502,1138092,4623,55422
449,2021-06-18,São Paulo,8528,1237476,116,35550,117513,4370587,3200,1687702,1142215,4123,59711
450,2021-06-19,São Paulo,924,1238400,37,35587,136768,4507355,2630,1690332,1146207,3992,56606
451,2021-06-20,São Paulo,0,1238400,19,35606,66333,4573688,993,1691325,1146188,-19,56606
452,2021-06-21,São Paulo,6881,1245281,98,35704,40649,4614337,1036,1692361,1150449,4261,59128
453,2021-06-22,São Paulo,5418,1250699,22,35726,47350,4661687,2316,1694677,1155096,4647,59877
454,2021-06-23,São Paulo,5281,1255980,29,35755,70772,4732459,3603,1698280,1159210,4114,61015
455,2021-06-24,São Paulo,3928,1259908,151,35906,94146,4826605,4659,1702939,1165000,5790,59002
456,2021-06-25,São Paulo,4243,1264151,131,36037,106896,4933501,2645,1705584,1169981,4981,58133
