,DATE,REGION,NEW_CASES,CUMULATIVE_CASES,NEW_DEATHS,CUMULATIVE_DEATHS,CUMULATIVE_RECOVERED,ACTIVE_CASES,NEW_FIRST_DOSES,CUMULATIVE_FIRST_DOSES,NEW_SECOND_DOSES,CUMULATIVE_SECOND_DOSES,NEW_RECOVERED
0,2020-03-26,São Paulo,0,565,0,50,0,515,0,0,0,0,515
1,2020-03-27,São Paulo,0,565,0,50,0,515,0,0,0,0,0
2,2020-03-28,São Paulo,0,565,13,63,0,502,0,0,0,0,-13
3,2020-03-29,São Paulo,0,565,13,76,0,489,0,0,0,0,-13
4,2020-03-30,São Paulo,28,593,24,100,0,493,0,0,0,0,4
5,2020-03-31,São Paulo,845,1438,18,118,0,1320,0,0,0,0,827
6,2020-04-01,São Paulo,65,1503,23,141,0,1362,0,0,0,0,42
7,2020-04-02,São Paulo,17,1520,24,165,0,1355,0,0,0,0,-7
8,2020-04-03,São Paulo,801,2321,48,213,0,2108,0,0,0,0,753
9,2020-04-04,São Paulo,408,2729,0,213,0,2516,0,0,0,0,408
10,2020-04-05,São Paulo,883,3612,6,219,0,3393,0,0,0,0,877
11,2020-04-06,São Paulo,142,3754,25,244,0,3510,0,0,0,0,117
12,2020-04-07,São Paulo,749,4503,53,297,0,4206,0,0,0,0,696
13,2020-04-08,São Paulo,634,5137,44,341,0,4796,0,0,0,0,590
14,2020-04-09,São Paulo,695,5832,45,386,0,5446,0,0,0,0,650
15,2020-04-10,São Paulo,547,6379,26,412,0,5967,0,0,0,0,521
16,2020-04-11,São Paulo,206,6585,10,422,0,6163,0,0,0,0,196
17,2020-04-12,São Paulo,220,6805,23,445,515,5845,0,0,0,0,-318
18,2020-04-13,São Paulo,26,6831,11,456,515,5860,0,0,0,0,15
19,2020-04-14,São Paulo,162,6993,64,520,502,5971,0,0,0,0,111
20,2020-04-15,São Paulo,1031,8024,43,563,489,6972,0,0,0,0,1001
21,2020-04-16,São Paulo,865,8889,47,610,493,7786,0,0,0,0,814
22,2020-04-17,São Paulo,468,9357,133,743,1320,7294,0,0,0,0,-492
23,2020-04-18,São Paulo,770,10127,64,807,1362,7958,0,0,0,0,664
24,2020-04-19,São Paulo,261,10388,40,847,1355,8186,0,0,0,0,228
25,2020-04-20,São Paulo,236,10624,49,896,2108,7620,0,0,0,0,-566
26,2020-04-21,São Paulo,641,11265,23,919,2516,7830,0,0,0,0,210
27,2020-04-22,São Paulo,118,11383,0,919,3393,7071,0,0,0,0,-759
28,2020-04-23,São Paulo,0,11383,205,1124,3510,6749,0,0,0,0,-322
29,2020-04-24,São Paulo,819,12202,0,1124,4206,6872,0,0,0,0,123
30,2020-04-25,São Paulo,1303,13505,29,1153,4796,7556,0,0,0,0,684
31,2020-04-26,São Paulo,469,13974,57,1210,5446,7318,0,0,0,0,-238
32,2020-04-27,São Paulo,130,14104,62,1272,5967,6865,0,0,0,0,-453
33,2020-04-28,São Paulo,1109,15213,65,1337,6163,7713,0,0,0,0,848
34,2020-04-29,São Paulo,712,15925,81,1418,6360,8147,0,0,0,0,434
35,2020-04-30,São Paulo,2513,18438,96,1514,6375,10549,0,0,0,0,2402
36,2020-05-01,São Paulo,1241,19679,151,1665,6473,11541,0,0,0,0,992
37,2020-05-02,São Paulo,218,19897,48,1713,7461,10723,0,0,0,0,-818
38,2020-05-03,São Paulo,567,20464,31,1744,8279,10441,0,0,0,0,-282
39,2020-05-04,São Paulo,384,20848,31,1775,8614,10459,0,0,0,0,18
40,2020-05-05,São Paulo,1401,22249,57,1832,9320,11097,0,0,0,0,638
41,2020-05-06,São Paulo,1558,23807,96,1928,9541,12338,0,0,0,0,1241
42,2020-05-07,São Paulo,1236,25043,78,2006,9728,13309,0,0,0,0,971
43,2020-05-08,São Paulo,1230,26273,100,2106,10346,13821,0,0,0,0,512
44,2020-05-09,São Paulo,1141,27414,81,2187,10464,14763,0,0,0,0,942
45,2020-05-10,São Paulo,613,28027,81,2268,10259,15500,0,0,0,0,737
46,2020-05-11,São Paulo,62,28089,37,2305,11078,14706,0,0,0,0,-794
47,2020-05-12,São Paulo,2368,30457,125,2430,12352,15675,0,0,0,0,969
48,2020-05-13,São Paulo,1915,32372,112,2542,12764,17066,0,0,0,0,1391
49,2020-05-14,São Paulo,1469,33841,60,2602,12832,18407,0,0,0,0,1341
50,2020-05-15,São Paulo,3265,37106,79,2681,13876,20549,0,0,0,0,2142
51,2020-05-16,São Paulo,1373,38479,85,2766,14507,21206,0,0,0,0,657
52,2020-05-17,São Paulo,126,38605,66,2832,16924,18849,0,0,0,0,-2357
53,2020-05-18,São Paulo,558,39163,13,2845,18014,18304,0,0,0,0,-545
54,2020-05-19,São Paulo,1587,40750,95,2940,18184,19626,0,0,0,0,1322
55,2020-05-20,São Paulo,1667,42417,147,3087,18720,20610,0,0,0,0,984
56,2020-05-21,São Paulo,2099,44516,99,3186,19073,22257,0,0,0,0,1647
57,2020-05-22,São Paulo,1699,46215,69,3255,20417,22543,0,0,0,0,286
58,2020-05-23,São Paulo,2313,48528,61,3316,21879,23333,0,0,0,0,790
59,2020-05-24,São Paulo,778,49306,35,3351,23037,22918,0,0,0,0,-415
60,2020-05-25,São Paulo,290,49596,39,3390,24167,22039,0,0,0,0,-879
61,2020-05-26,São Paulo,2256,51852,31,3421,25227,23204,0,0,0,0,1165
62,2020-05-27,São Paulo,3096,54948,198,3619,25759,25570,0,0,0,0,2366
63,2020-05-28,São Paulo,1827,56775,100,3719,25784,27272,0,0,0,0,1702
64,2020-05-29,São Paulo,3094,59869,104,3823,28027,28019,0,0,0,0,747
65,2020-05-30,São Paulo,3760,63629,329,4152,29830,29647,0,0,0,0,1628
66,2020-05-31,São Paulo,1409,65038,60,4212,31239,29587,0,0,0,0,-60
67,2020-06-01,São Paulo,678,65716,29,4241,34425,27050,0,0,0,0,-2537
68,2020-06-02,São Paulo,3282,68998,64,4305,35713,28980,0,0,0,0,1930
69,2020-06-03,São Paulo,3173,72171,175,4480,35773,31918,0,0,0,0,2938
70,2020-06-04,São Paulo,1042,73213,88,4568,36318,32327,0,0,0,0,409
71,2020-06-05,São Paulo,4555,77768,120,4688,37810,35270,0,0,0,0,2943
72,2020-06-06,São Paulo,2112,79880,82,4770,39330,35780,0,0,0,0,510
73,2020-06-07,São Paulo,1229,81109,43,4813,41330,34966,0,0,0,0,-814
74,2020-06-08,São Paulo,1070,82179,25,4838,42960,34381,0,0,0,0,-585
75,2020-06-09,São Paulo,2683,84862,107,4945,45212,34705,0,0,0,0,324
76,2020-06-10,São Paulo,1521,86383,178,5123,45955,35305,0,0,0,0,600
77,2020-06-11,São Paulo,2766,89149,83,5206,46206,37737,0,0,0,0,2432
78,2020-06-12,São Paulo,3021,92170,46,5252,48431,38487,0,0,0,0,750
79,2020-06-13,São Paulo,2672,94842,114,5366,51329,38147,0,0,0,0,-340
80,2020-06-14,São Paulo,2403,97245,62,5428,53056,38761,0,0,0,0,614
81,2020-06-15,São Paulo,3382,100627,46,5474,56046,39107,0,0,0,0,346
82,2020-06-16,São Paulo,5031,105658,298,5772,59477,40409,0,0,0,0,1302
83,2020-06-17,São Paulo,3534,109192,170,5942,60826,42424,0,0,0,0,2015
84,2020-06-18,São Paulo,0,109192,205,6147,61475,41570,0,0,0,0,-854
85,2020-06-19,São Paulo,0,109192,68,6215,64693,38284,0,0,0,0,-3286
86,2020-06-20,São Paulo,8576,117768,103,6318,67691,43759,0,0,0,0,5475
87,2020-06-21,São Paulo,940,118708,65,6383,68645,43680,0,0,0,0,-79
88,2020-06-22,São Paulo,0,118708,71,6454,73080,39174,0,0,0,0,-4506
89,2020-06-23,São Paulo,641,119349,153,6607,75110,37632,0,0,0,0,-1542
90,2020-06-24,São Paulo,18990,138339,115,6722,76296,55321,0,0,0,0,17689
91,2020-06-25,São Paulo,4411,142750,70,6792,77341,58617,0,0,0,0,3296
92,2020-06-26,São Paulo,4366,147116,74,6866,79917,60333,0,0,0,0,1716
93,2020-06-27,São Paulo,420,147536,54,6920,81260,59356,0,0,0,0,-977
94,2020-06-28,São Paulo,3221,150757,25,6945,83943,59869,0,0,0,0,513
95,2020-06-29,São Paulo,153,150910,37,6982,86918,57010,0,0,0,0,-2859
96,2020-06-30,São Paulo,504,151414,141,7123,89476,54815,0,0,0,0,-2195
97,2020-07-01,São Paulo,8923,160337,204,7327,91817,61193,0,0,0,0,6378
98,2020-07-02,São Paulo,2849,163186,91,7418,95153,60615,0,0,0,0,-578
99,2020-07-03,São Paulo,2380,165566,67,7485,99886,58195,0,0,0,0,-2420
100,2020-07-04,São Paulo,2822,168388,43,7528,103250,57610,0,0,0,0,-585
101,2020-07-05,São Paulo,1954,170342,46,7574,103045,59723,0,0,0,0,2113
102,2020-07-06,São Paulo,827,171169,34,7608,102977,60584,0,0,0,0,861
103,2020-07-07,São Paulo,2411,173580,131,7739,111450,54391,0,0,0,0,-6193
104,2020-07-08,São Paulo,2723,176303,150,7889,112325,56089,0,0,0,0,1698
105,2020-07-09,São Paulo,1815,178118,98,7987,112254,57877,0,0,0,0,1788
106,2020-07-10,São Paulo,313,178431,85,8072,112742,57617,0,0,0,0,-260
107,2020-07-11,São Paulo,350,178781,74,8146,131617,39018,0,0,0,0,-18599
108,2020-07-12,São Paulo,118,178899,42,8188,135958,34753,0,0,0,0,-4265
109,2020-07-13,São Paulo,98,178997,30,8218,140250,30529,0,0,0,0,-4224
110,2020-07-14,São Paulo,404,179401,225,8443,140616,30342,0,0,0,0,-187
111,2020-07-15,São Paulo,449,179850,131,8574,143812,27464,0,0,0,0,-2878
112,2020-07-16,São Paulo,600,180450,134,8708,143928,27814,0,0,0,0,350
113,2020-07-17,São Paulo,306,180756,51,8759,144291,27706,0,0,0,0,-108
114,2020-07-18,São Paulo,319,181075,0,8759,153010,19306,0,0,0,0,-8400
115,2020-07-19,São Paulo,83,181158,0,8759,155768,16631,0,0,0,0,-2675
116,2020-07-20,São Paulo,120,181278,0,8759,158081,14438,0,0,0,0,-2193
117,2020-07-21,São Paulo,491,181769,277,9036,160860,11873,0,0,0,0,-2565
118,2020-07-22,São Paulo,18601,200370,0,9036,162768,28566,0,0,0,0,16693
119,2020-07-23,São Paulo,2201,202571,220,9256,163561,29754,0,0,0,0,1188
120,2020-07-24,São Paulo,737,203308,77,9333,165841,28134,0,0,0,0,-1620
121,2020-07-25,São Paulo,4436,207744,70,9403,168414,29927,0,0,0,0,1793
122,2020-07-26,São Paulo,0,207744,0,9403,170131,28210,0,0,0,0,-1717
123,2020-07-27,São Paulo,189,207933,0,9403,170359,28171,0,0,0,0,-39
124,2020-07-28,São Paulo,5503,213436,137,9540,170635,33261,0,0,0,0,5090
125,2020-07-29,São Paulo,6858,220294,121,9661,170711,39922,0,0,0,0,6661
126,2020-07-30,São Paulo,3277,223571,49,9710,170779,43082,0,0,0,0,3160
127,2020-07-31,São Paulo,2016,225587,42,9752,170958,44877,0,0,0,0,1795
128,2020-08-01,São Paulo,4728,230315,82,9834,171276,49205,0,0,0,0,4328
129,2020-08-02,São Paulo,60,230375,29,9863,171742,48770,0,0,0,0,-435
130,2020-08-03,São Paulo,37,230412,20,9883,171997,48532,0,0,0,0,-238
131,2020-08-04,São Paulo,3051,233463,59,9942,172316,51205,0,0,0,0,2673
132,2020-08-05,São Paulo,2715,236178,113,10055,172399,53724,0,0,0,0,2519
133,2020-08-06,São Paulo,6592,242770,104,10159,172519,60092,0,0,0,0,6368
134,2020-08-07,São Paulo,1561,244331,87,10246,172733,61352,0,0,0,0,1260
135,2020-08-08,São Paulo,2319,246650,57,10303,191334,45013,0,0,0,0,-16339
136,2020-08-09,São Paulo,80,246730,20,10323,193315,43092,0,0,0,0,-1921
137,2020-08-10,São Paulo,57,246787,16,10339,193975,42473,0,0,0,0,-619
138,2020-08-11,São Paulo,2963,249750,134,10473,198341,40936,0,0,0,0,-1537
139,2020-08-12,São Paulo,8731,258481,140,10613,198341,49527,0,0,0,0,8591
140,2020-08-13,São Paulo,8758,267239,62,10675,198530,58034,0,0,0,0,8507
141,2020-08-14,São Paulo,2595,269834,83,10758,203896,55180,0,0,0,0,-2854
142,2020-08-15,São Paulo,1598,271432,51,10809,210633,49990,0,0,0,0,-5190
143,2020-08-16,São Paulo,638,272070,17,10826,213861,47383,0,0,0,0,-2607
144,2020-08-17,São Paulo,363,272433,34,10860,215835,45738,0,0,0,0,-1645
145,2020-08-18,São Paulo,814,273247,35,10895,220481,41871,0,0,0,0,-3867
146,2020-08-19,São Paulo,2287,275534,174,11069,220512,43953,0,0,0,0,2082
147,2020-08-20,São Paulo,1916,277450,146,11215,220529,45706,0,0,0,0,1753
148,2020-08-21,São Paulo,1120,278570,214,11429,223521,43620,0,0,0,0,-2086
149,2020-08-22,São Paulo,4191,282761,2,11431,226123,45207,0,0,0,0,1587
150,2020-08-23,São Paulo,1309,284070,23,11454,232611,40005,0,0,0,0,-5202
151,2020-08-24,São Paulo,101,284171,25,11479,234085,38607,0,0,0,0,-1398
152,2020-08-25,São Paulo,2808,286979,94,11573,236347,39059,0,0,0,0,452
153,2020-08-26,São Paulo,2085,289064,250,11823,236407,40834,0,0,0,0,1775
154,2020-08-27,São Paulo,2689,291753,110,11933,236448,43372,0,0,0,0,2538
155,2020-08-28,São Paulo,2001,293754,52,11985,239277,42492,0,0,0,0,-880
156,2020-08-29,São Paulo,1226,294980,24,12009,247868,35103,0,0,0,0,-7389
157,2020-08-30,São Paulo,270,295250,44,12053,256564,26633,0,0,0,0,-8470
158,2020-08-31,São Paulo,185,295435,7,12060,259076,24299,0,0,0,0,-2334
159,2020-09-01,São Paulo,3263,298698,83,12143,260623,25932,0,0,0,0,1633
160,2020-09-02,São Paulo,2145,300843,133,12276,261244,27323,0,0,0,0,1391
161,2020-09-03,São Paulo,2391,303234,120,12396,261573,29265,0,0,0,0,1942
162,2020-09-04,São Paulo,1520,304754,162,12558,262352,29844,0,0,0,0,579
163,2020-09-05,São Paulo,1288,306042,27,12585,264465,28992,0,0,0,0,-852
164,2020-09-06,São Paulo,319,306361,0,12585,266235,27541,0,0,0,0,-1451
165,2020-09-07,São Paulo,168,306529,10,12595,267141,26793,0,0,0,0,-748
166,2020-09-08,São Paulo,480,307009,0,12595,271330,23084,0,0,0,0,-3709
167,2020-09-09,São Paulo,1831,308840,67,12662,272616,23562,0,0,0,0,478
168,2020-09-10,São Paulo,1649,310489,105,12767,272692,25030,0,0,0,0,1468
169,2020-09-11,São Paulo,1600,312089,36,12803,275406,23880,0,0,0,0,-1150
170,2020-09-12,São Paulo,1462,313551,14,12817,277241,23493,0,0,0,0,-387
171,2020-09-13,São Paulo,307,313858,33,12850,279820,21188,0,0,0,0,-2305
172,2020-09-14,São Paulo,0,313858,12,12862,281769,19227,0,0,0,0,-1961
173,2020-09-15,São Paulo,2018,315876,68,12930,282971,19975,0,0,0,0,748
174,2020-09-16,São Paulo,1527,317403,181,13111,283197,21095,0,0,0,0,1120
175,2020-09-17,São Paulo,1565,318968,55,13166,283375,22427,0,0,0,0,1332
176,2020-09-18,São Paulo,1709,320677,78,13244,286555,20878,0,0,0,0,-1549
177,2020-09-19,São Paulo,254,320931,35,13279,288567,19085,0,0,0,0,-1793
178,2020-09-20,São Paulo,30,320961,43,13322,290838,16801,0,0,0,0,-2284
179,2020-09-21,São Paulo,52,321013,17,13339,292196,15478,0,0,0,0,-1323
180,2020-09-22,São Paulo,348,321361,26,13365,293457,14539,0,0,0,0,-939
181,2020-09-23,São Paulo,272,321633,98,13463,293776,14394,0,0,0,0,-145
182,2020-09-24,São Paulo,218,321851,64,13527,293934,14390,0,0,0,0,-4
183,2020-09-25,São Paulo,6426,328277,34,13561,294414,20302,0,0,0,0,5912
184,2020-09-26,São Paulo,1156,329433,9,13570,296178,19685,0,0,0,0,-617
185,2020-09-27,São Paulo,271,329704,0,13570,297722,18412,0,0,0,0,-1273
186,2020-09-28,São Paulo,399,330103,10,13580,299286,17237,0,0,0,0,-1175
187,2020-09-29,São Paulo,1419,331522,105,13685,300734,17103,0,0,0,0,-134
188,2020-09-30,São Paulo,1428,332950,18,13703,301008,18239,0,0,0,0,1136
189,2020-10-01,São Paulo,1227,334177,19,13722,300996,19459,0,0,0,0,1220
190,2020-10-02,São Paulo,1153,335330,20,13742,302946,18642,0,0,0,0,-817
191,2020-10-03,São Paulo,1440,336770,1,13743,304292,18735,0,0,0,0,93
192,2020-10-04,São Paulo,303,337073,0,13743,305802,17528,0,0,0,0,-1207
193,2020-10-05,São Paulo,133,337206,78,13821,307433,15952,0,0,0,0,-1576
194,2020-10-06,São Paulo,0,337206,51,13872,307652,15682,0,0,0,0,-270
195,2020-10-07,São Paulo,2571,339777,130,14002,307639,18136,0,0,0,0,2454
196,2020-10-08,São Paulo,965,340742,40,14042,307674,19026,0,0,0,0,890
197,2020-10-09,São Paulo,1603,342345,0,14042,307996,20307,0,0,0,0,1281
198,2020-10-10,São Paulo,1229,343574,36,14078,308170,21326,0,0,0,0,1019
199,2020-10-11,São Paulo,318,343892,12,14090,308324,21478,0,0,0,0,152
200,2020-10-12,São Paulo,145,344037,0,14090,314716,15231,0,0,0,0,-6247
201,2020-10-13,São Paulo,211,344248,0,14090,315863,14295,0,0,0,0,-936
202,2020-10-14,São Paulo,1247,345495,48,14138,316134,15223,0,0,0,0,928
203,2020-10-15,São Paulo,1523,347018,40,14178,316523,16317,0,0,0,0,1094
204,2020-10-16,São Paulo,1360,348378,21,14199,317837,16342,0,0,0,0,25
205,2020-10-17,São Paulo,201,348579,25,14224,319247,15108,0,0,0,0,-1234
206,2020-10-18,São Paulo,1111,349690,1,14225,320455,15010,0,0,0,0,-98
207,2020-10-19,São Paulo,1021,350711,20,14245,321588,14878,0,0,0,0,-132
208,2020-10-20,São Paulo,1166,351877,8,14253,323027,14597,0,0,0,0,-281
209,2020-10-21,São Paulo,1076,352953,31,14284,323330,15339,0,0,0,0,742
210,2020-10-22,São Paulo,999,353952,9,14293,323385,16274,0,0,0,0,935
211,2020-10-23,São Paulo,1784,355736,22,14315,323334,18087,0,0,0,0,1813
212,2020-10-24,São Paulo,1440,357176,3,14318,325775,17083,0,0,0,0,-1004
213,2020-10-25,São Paulo,410,357586,7,14325,326700,16561,0,0,0,0,-522
214,2020-10-26,São Paulo,163,357749,15,14340,328303,15106,0,0,0,0,-1455
215,2020-10-27,São Paulo,1767,359516,3,14343,329496,15677,0,0,0,0,571
216,2020-10-28,São Paulo,1550,361066,34,14377,329802,16887,0,0,0,0,1210
217,2020-10-29,São Paulo,1399,362465,6,14383,329947,18135,0,0,0,0,1248
218,2020-10-30,São Paulo,1398,363863,15,14398,330158,19307,0,0,0,0,1172
219,2020-10-31,São Paulo,788,364651,0,14398,331357,18896,0,0,0,0,-411
220,2020-11-01,São Paulo,23,364674,0,14398,332840,17436,0,0,0,0,-1460
221,2020-11-02,São Paulo,390,365064,0,14398,334179,16487,0,0,0,0,-949
222,2020-11-03,São Paulo,297,365361,104,14502,334355,16504,0,0,0,0,17
223,2020-11-04,São Paulo,1119,366480,43,14545,335465,16470,0,0,0,0,-34
224,2020-11-05,São Paulo,1121,367601,27,14572,336466,16563,0,0,0,0,93
225,2020-11-06,São Paulo,0,367601,2,14574,337624,15403,0,0,0,0,-1160
226,2020-11-07,São Paulo,0,367601,7,14581,338669,14351,0,0,0,0,-1052
227,2020-11-08,São Paulo,0,367601,15,14596,339659,13346,0,0,0,0,-1005
228,2020-11-09,São Paulo,0,367601,18,14614,341421,11566,0,0,0,0,-1780
229,2020-11-10,São Paulo,6453,374054,52,14666,342858,16530,0,0,0,0,4964
230,2020-11-11,São Paulo,2227,376281,31,14697,343261,18323,0,0,0,0,1793
231,2020-11-12,São Paulo,1879,378160,12,14709,343409,20042,0,0,0,0,1719
232,2020-11-13,São Paulo,0,378160,4,14713,345173,18274,0,0,0,0,-1768
233,2020-11-14,São Paulo,4028,382188,10,14723,346689,20776,0,0,0,0,2502
234,2020-11-15,São Paulo,393,382581,10,14733,348082,19766,0,0,0,0,-1010
235,2020-11-16,São Paulo,220,382801,35,14768,349465,18568,0,0,0,0,-1198
236,2020-11-17,São Paulo,2415,385216,12,14780,350253,20183,0,0,0,0,1615
237,2020-11-18,São Paulo,2012,387228,40,14820,350276,22132,0,0,0,0,1949
238,2020-11-19,São Paulo,2481,389709,14,14834,350666,24209,0,0,0,0,2077
239,2020-11-20,São Paulo,2574,392283,21,14855,350859,26569,0,0,0,0,2360
240,2020-11-21,São Paulo,1784,394067,8,14863,351935,27269,0,0,0,0,700
241,2020-11-22,São Paulo,709,394776,13,14876,353029,26871,0,0,0,0,-398
242,2020-11-23,São Paulo,125,394901,38,14914,353027,26960,0,0,0,0,89
243,2020-11-24,São Paulo,1813,396714,100,15014,353020,28680,0,0,0,0,1720
244,2020-11-25,São Paulo,2668,399382,48,15062,353005,31315,0,0,0,0,2635
245,2020-11-26,São Paulo,1334,400716,20,15082,352987,32647,0,0,0,0,1332
246,2020-11-27,São Paulo,1052,401768,34,15116,359388,27264,0,0,0,0,-5383
247,2020-11-28,São Paulo,4594,406362,12,15128,361584,29650,0,0,0,0,2386
248,2020-11-29,São Paulo,541,406903,2,15130,363451,28322,0,0,0,0,-1328
249,2020-11-30,São Paulo,223,407126,20,15150,363447,28529,0,0,0,0,207
250,2020-12-01,São Paulo,2707,409833,43,15193,367465,27175,0,0,0,0,-1354
251,2020-12-02,São Paulo,6049,415882,54,15247,367848,32787,0,0,0,0,5612
252,2020-12-03,São Paulo,2320,418202,42,15289,368033,34880,0,0,0,0,2093
253,2020-12-04,São Paulo,2401,420603,40,15329,370436,34838,0,0,0,0,-42
254,2020-12-05,São Paulo,2418,423021,18,15347,372408,35266,0,0,0,0,428
255,2020-12-06,São Paulo,754,423775,26,15373,374875,33527,0,0,0,0,-1739
256,2020-12-07,São Paulo,225,424000,28,15401,377428,31171,0,0,0,0,-2356
257,2020-12-08,São Paulo,2439,426439,37,15438,379204,31797,0,0,0,0,626
258,2020-12-09,São Paulo,2795,429234,67,15505,379900,33829,0,0,0,0,2032
259,2020-12-10,São Paulo,14461,443695,48,15553,379987,48155,0,0,0,0,14326
260,2020-12-11,São Paulo,2644,446339,45,15598,381700,49041,0,0,0,0,886
261,2020-12-12,São Paulo,2096,448435,9,15607,384320,48508,0,0,0,0,-533
262,2020-12-13,São Paulo,254,448689,19,15626,385634,47429,0,0,0,0,-1079
263,2020-12-14,São Paulo,466,449155,50,15676,386652,46827,0,0,0,0,-602
264,2020-12-15,São Paulo,1113,450268,25,15701,391234,43333,0,0,0,0,-3494
265,2020-12-16,São Paulo,3481,453749,80,15781,391773,46195,0,0,0,0,2862
266,2020-12-17,São Paulo,2823,456572,30,15811,391976,48785,0,0,0,0,2590
267,2020-12-18,São Paulo,2674,459246,43,15854,394640,48752,0,0,0,0,-33
268,2020-12-19,São Paulo,2420,461666,26,15880,400635,45151,0,0,0,0,-3601
269,2020-12-20,São Paulo,818,462484,14,15894,402913,43677,0,0,0,0,-1474
270,2020-12-21,São Paulo,443,462927,17,15911,405274,41742,0,0,0,0,-1935
271,2020-12-22,São Paulo,3037,465964,35,15946,407674,42344,0,0,0,0,602
272,2020-12-23,São Paulo,3025,468989,13,15959,408402,44628,0,0,0,0,2284
273,2020-12-24,São Paulo,0,468989,83,16042,408599,44348,0,0,0,0,-280
274,2020-12-25,São Paulo,0,468989,33,16075,411001,41913,0,0,0,0,-2435
275,2020-12-26,São Paulo,4542,473531,9,16084,413729,43718,0,0,0,0,1805
276,2020-12-27,São Paulo,789,474320,5,16089,428142,30089,0,0,0,0,-13629
277,2020-12-28,São Paulo,626,474946,3,16092,430741,28113,0,0,0,0,-1976
278,2020-12-29,São Paulo,3884,478830,71,16163,432828,29839,0,0,0,0,1726
279,2020-12-30,São Paulo,3722,482552,218,16381,433063,33108,0,0,0,0,3269
280,2020-12-31,São Paulo,0,482522,2,16383,433479,32660,0,0,0,0,-448
281,2021-01-01,São Paulo,0,482522,25,16408,434567,31547,0,0,0,0,-1113
282,2021-01-02,São Paulo,4717,487239,49,16457,437968,32814,0,0,0,0,1267
283,2021-01-03,São Paulo,988,488227,6,16463,440761,31003,0,0,0,0,-1811
284,2021-01-04,São Paulo,427,488654,1,16464,443392,28798,0,0,0,0,-2205
285,2021-01-05,São Paulo,3424,492078,1,16465,445786,29827,0,0,0,0,1029
286,2021-01-06,São Paulo,3683,495761,90,16555,446590,32616,0,0,0,0,2789
287,2021-01-07,São Paulo,3515,499276,171,16726,447016,35534,0,0,0,0,2918
288,2021-01-08,São Paulo,4653,503929,82,16808,450018,37103,0,0,0,0,1569
289,2021-01-09,São Paulo,3231,507160,28,16836,453030,37294,0,0,0,0,191
290,2021-01-10,São Paulo,1086,508246,45,16881,452947,38418,0,0,0,0,1124
291,2021-01-11,São Paulo,779,509025,25,16906,452914,39205,0,0,0,0,787
292,2021-01-12,São Paulo,2480,511505,84,16990,457447,37068,0,0,0,0,-2137
293,2021-01-13,São Paulo,4274,515779,117,17107,458231,40441,0,0,0,0,3373
294,2021-01-14,São Paulo,3597,519376,66,17173,458854,43349,0,0,0,0,2908
295,2021-01-15,São Paulo,3991,523367,54,17227,462667,43473,0,0,0,0,124
296,2021-01-16,São Paulo,3530,526897,17,17244,466171,43482,0,0,0,0,9
297,2021-01-17,São Paulo,1159,528056,37,17281,466139,44636,0,0,0,0,1154
298,2021-01-18,São Paulo,753,528809,34,17315,466114,45380,0,0,0,0,744
299,2021-01-19,São Paulo,4410,533219,54,17369,470782,45068,0,0,0,0,-312
300,2021-01-20,São Paulo,3894,537113,124,17493,471764,47856,0,0,0,0,2788
301,2021-01-21,São Paulo,3505,540618,79,17572,472190,50856,0,0,0,0,3000
302,2021-01-22,São Paulo,2142,542760,184,17756,475613,49391,0,0,0,0,-1465
303,2021-01-23,São Paulo,3763,546523,0,17756,479206,49561,0,0,0,0,170
304,2021-01-24,São Paulo,1135,547658,0,17756,482550,47352,0,0,0,0,-2209
305,2021-01-25,São Paulo,578,548236,0,17756,487121,43359,0,0,0,0,-3993
306,2021-01-26,São Paulo,1550,549786,67,17823,490324,41639,0,0,0,0,-1720
307,2021-01-27,São Paulo,4081,553867,95,17918,491365,44584,0,0,0,0,2945
308,2021-01-28,São Paulo,4138,558005,144,18062,492119,47824,0,0,0,0,3240
309,2021-01-29,São Paulo,3974,561979,55,18117,494515,49347,0,0,0,0,1523
310,2021-01-30,São Paulo,2740,564719,30,18147,498672,47900,0,0,0,0,-1447
311,2021-01-31,São Paulo,813,565532,1,18148,502203,45181,0,0,0,0,-2719
312,2021-02-01,São Paulo,614,566146,92,18240,506140,41766,0,0,0,0,-3415
313,2021-02-02,São Paulo,4266,570412,44,18284,509653,42475,0,0,0,0,709
314,2021-02-03,São Paulo,3486,573898,83,18367,510775,44756,0,0,0,0,2281
315,2021-02-04,São Paulo,4326,578224,106,18473,511494,48257,0,0,0,0,3501
316,2021-02-05,São Paulo,3016,581240,97,18570,515850,46820,0,0,0,0,-1437
317,2021-02-06,São Paulo,2981,584221,78,18648,519620,45953,0,0,0,0,-867
318,2021-02-07,São Paulo,959,585180,2,18650,523046,43484,0,0,0,0,-2469
319,2021-02-08,São Paulo,585,585765,53,18703,525004,42058,0,0,0,0,-1426
320,2021-02-09,São Paulo,3399,589164,75,18778,528767,41619,0,0,0,0,-439
321,2021-02-10,São Paulo,3326,592490,112,18890,529902,43698,0,0,0,0,2079
322,2021-02-11,São Paulo,5274,597764,51,18941,530480,48343,0,0,0,0,4645
323,2021-02-12,São Paulo,5618,603382,78,19019,531963,52400,0,0,0,0,4057
324,2021-02-13,São Paulo,2882,606264,49,19068,535949,51247,0,0,0,0,-1153
325,2021-02-14,São Paulo,2734,608998,14,19082,539943,49973,0,0,0,0,-1274
326,2021-02-15,São Paulo,2741,611739,47,19129,543862,48748,0,0,0,0,-1225
327,2021-02-16,São Paulo,2913,614652,15,19144,546572,48936,0,0,0,0,188
328,2021-02-17,São Paulo,3109,617761,115,19259,547384,51118,0,0,0,0,2182
329,2021-02-18,São Paulo,15354,633115,33,19292,547906,65917,0,0,0,0,14799
330,2021-02-19,São Paulo,5384,638499,53,19345,552128,67026,0,0,0,0,1109
331,2021-02-20,São Paulo,5149,643648,10,19355,555531,68762,0,0,0,0,1736
332,2021-02-21,São Paulo,3562,647210,40,19395,559751,68064,0,758,0,0,-698
333,2021-02-22,São Paulo,3352,650562,0,19382,562670,68510,0,9600,0,0,446
334,2021-02-23,São Paulo,5479,656041,74,19456,565573,71012,0,9531,0,0,2502
335,2021-02-24,São Paulo,5779,661820,103,19559,566530,75731,0,6820,0,0,4719
336,2021-02-25,São Paulo,2696,664516,0,19559,567062,77895,0,0,0,0,2164
337,2021-02-26,São Paulo,8070,672586,111,19670,570386,82530,0,15741,0,0,4635
338,2021-02-27,São Paulo,4970,677556,6,19676,573600,84280,0,0,0,0,1750
339,2021-02-28,São Paulo,2696,680252,2,19678,578823,81751,0,5941,0,0,-2529
340,2021-03-01,São Paulo,4367,684619,312,19990,584363,80266,0,5175,0,0,-1485
341,2021-03-02,São Paulo,5270,689889,44,20034,587196,82659,0,12513,0,0,2393
342,2021-03-03,São Paulo,5824,695713,107,20141,589916,85656,0,9078,0,0,2997
343,2021-03-04,São Paulo,6074,701787,90,20231,592610,88946,0,11619,0,0,3290
344,2021-03-05,São Paulo,5911,707698,77,20308,595508,91882,0,17293,0,0,2936
345,2021-03-06,São Paulo,5530,713228,12,20320,598502,94406,0,9292,0,0,2524
346,2021-03-07,São Paulo,4240,717468,55,20375,613823,83270,0,1384,0,0,-11136
347,2021-03-08,São Paulo,3859,721327,28,20403,619154,81770,0,10326,0,0,-1500
348,2021-03-09,São Paulo,5984,727311,94,20497,624293,82521,0,10369,0,0,751
349,2021-03-10,São Paulo,6629,733940,76,20573,627815,85552,0,11467,0,0,3031
350,2021-03-11,São Paulo,5890,739830,91,20664,631180,87986,0,12455,0,0,2434
351,2021-03-12,São Paulo,5132,744962,79,20743,636585,87634,0,15022,0,0,-352
352,2021-03-13,São Paulo,6447,751409,45,20788,642261,88360,0,5753,0,0,726
353,2021-03-14,São Paulo,4741,756150,65,20853,644957,90340,0,959,0,0,1980
354,2021-03-15,São Paulo,4185,760335,171,21024,652916,86395,0,6257,0,0,-3945
355,2021-03-16,São Paulo,4772,765107,109,21133,657880,86094,0,9024,0,0,-301
356,2021-03-17,São Paulo,6362,771469,240,21373,660574,89522,0,8701,0,0,3428
357,2021-03-18,São Paulo,5913,777382,3,21376,664629,91377,0,8150,0,0,1855
358,2021-03-19,São Paulo,5828,783210,241,21617,669855,91738,0,5744,0,0,361
359,2021-03-20,São Paulo,5562,788772,188,21805,675572,91395,0,3273,0,0,-343
360,2021-03-21,São Paulo,2696,791468,57,21862,681556,88050,0,336,0,0,-3345
361,2021-03-22,São Paulo,6086,797554,165,22027,687390,88137,0,6040,0,0,87
362,2021-03-23,São Paulo,4361,801915,18,22045,692908,86962,0,11098,0,0,-1175
363,2021-03-24,São Paulo,6003,807918,106,22151,697093,88674,0,23336,0,0,1712
364,2021-03-25,São Paulo,5829,813747,275,22426,700924,90397,0,24659,0,0,1723
365,2021-03-26,São Paulo,6102,819849,297,22723,706814,90312,0,14847,0,0,-85
366,2021-03-27,São Paulo,26720,846569,79,22802,713367,110400,0,8447,0,0,20088
367,2021-03-28,São Paulo,2696,849265,138,22940,719166,107159,0,1743,0,0,-3241
368,2021-03-29,São Paulo,5672,854937,383,23323,724219,107395,0,8002,0,0,236
369,2021-03-30,São Paulo,7624,862561,70,23393,730621,108547,0,11426,0,0,1152
370,2021-03-31,São Paulo,14020,876581,85,23478,735297,117806,0,11038,0,0,9259
371,2021-04-01,São Paulo,4906,749383,72,23550,650343,75490,18610,1332654,11152,471054,-42316
372,2021-04-02,São Paulo,3537,752920,32,23582,652310,77028,25651,1358305,5971,477025,1538
373,2021-04-03,São Paulo,1510,754430,475,24057,655736,74637,18626,1376931,1600,478625,-2391
374,2021-04-04,São Paulo,1634,756064,178,24235,658950,72879,5826,1382757,679,479304,-1758
375,2021-04-05,São Paulo,1223,757287,686,24921,661841,70525,17575,1400332,26320,505624,-2354
376,2021-04-06,São Paulo,4310,761597,15,24936,664519,72142,31080,1431412,36670,542294,1617
377,2021-04-07,São Paulo,2435,764032,398,25334,664462,74236,48077,1479489,32748,575042,2094
378,2021-04-08,São Paulo,2198,766230,802,26136,667687,72407,28848,1508337,20979,596021,-1829
379,2021-04-09,São Paulo,708,766938,425,26561,669334,71043,17269,1525606,56489,652510,-1364
380,2021-04-10,São Paulo,633,767571,253,26814,672535,68222,23177,1548783,42964,695474,-2821
381,2021-04-11,São Paulo,0,767571,117,26931,675393,65247,12269,1561052,3914,699388,-2975
382,2021-04-12,São Paulo,211,767782,276,27207,678502,62073,31827,1592879,20142,719530,-3174
383,2021-04-13,São Paulo,934,768716,6,27213,702447,39056,46155,1639034,27447,746977,-23017
384,2021-04-14,São Paulo,2538,771254,287,27500,702309,41445,29139,1668173,17346,764323,2389
385,2021-04-15,São Paulo,2141,773395,319,27819,704902,40674,20847,1689020,16588,780911,-771
386,2021-04-16,São Paulo,654,774049,224,28043,709760,36246,15589,1704609,69898,850809,-4428
387,2021-04-17,São Paulo,4902,778951,171,28214,720999,29738,9174,1713783,47769,898578,-6508
388,2021-04-18,São Paulo,0,778951,48,28262,725833,24856,2010,1715793,4865,903443,-4882
389,2021-04-19,São Paulo,186148,965099,240,28502,729338,33199,56904,1772697,25390,928833,8343
390,2021-04-20,São Paulo,6487,971586,3,28505,730373,38648,-37455,1735242,34039,962872,5449
391,2021-04-21,São Paulo,5772,977358,203,28708,731829,42761,89833,1825075,21853,984725,4113
392,2021-04-22,São Paulo,3399,980757,61,28769,732366,45562,50653,1875728,17062,1001787,2801
393,2021-04-23,São Paulo,6026,986783,263,29032,736661,47030,48234,1923962,35593,1037380,1468
394,2021-04-24,São Paulo,4900,991683,138,29170,738698,49755,32291,1956253,23913,1061293,2725
395,2021-04-25,São Paulo,0,991683,41,29211,740094,48318,4133,1960386,4658,1065951,-1437
396,2021-04-26,São Paulo,2916,994599,258,29469,740377,50693,0,1960386,0,1065951,2375
397,2021-04-27,São Paulo,6077,1000676,3,29472,740757,56387,33185,1993571,53111,1119062,5694
398,2021-04-28,São Paulo,6087,1006763,204,29676,740640,62387,8248,2001819,26016,1145078,6000
399,2021-04-29,São Paulo,36500,1043263,587,30263,740575,98365,38702,2040521,23045,1168123,35978
400,2021-04-30,São Paulo,4798,1048061,187,30450,741503,102048,39227,2079748,21428,1189551,3683
401,2021-05-01,São Paulo,4129,1052190,40,30490,743754,103886,15330,2095078,20217,1209768,1838
402,2021-05-02,São Paulo,0,1052190,17,30507,745576,102047,1859,2096937,4280,1214048,-1839
403,2021-05-03,São Paulo,2464,1054654,202,30709,746006,103879,7259,2104196,25398,1239446,1832
404,2021-05-04,São Paulo,4658,1059312,30,30739,750737,103776,12624,2116820,32556,1272002,-103
405,2021-05-05,São Paulo,4416,1063728,33,30772,750689,108207,10694,2127514,31460,1303462,4431
406,2021-05-06,São Paulo,4252,1067980,180,30952,762537,100431,97002,2224516,51542,1355004,-7776
407,2021-05-07,São Paulo,4256,1072236,142,31094,769021,98061,91791,2316307,14418,1369422,-2370
408,2021-05-08,São Paulo,3366,1075602,89,31183,774590,95769,61318,2377625,12921,1382343,-2292
409,2021-05-09,São Paulo,0,1075602,35,31218,777928,92396,14351,2391976,3537,1385880,-3373
410,2021-05-10,São Paulo,2864,1078466,136,31354,957751,89361,13904,2405880,8306,1394186,-3035
411,2021-05-11,São Paulo,5163,1083629,1,31355,962513,89761,27094,2432974,12063,1406249,400
412,2021-05-12,São Paulo,4865,1088494,143,31498,962472,94524,53629,2486603,8264,1414513,4763
413,2021-05-13,São Paulo,4286,1092780,529,32027,965130,95623,51986,2538589,8975,1423488,1099
414,2021-05-14,São Paulo,4706,1097486,95,32122,971204,94160,65192,2603781,8352,1431840,-1463
415,2021-05-15,São Paulo,4058,1101544,51,32173,977087,92284,79016,2682797,5854,1437694,-1876
416,2021-05-16,São Paulo,0,1101544,110,32283,1013000,56261,27262,2710059,1592,1439286,-36023
417,2021-05-17,São Paulo,3653,1105197,111,32394,1017611,55192,19328,2729387,3387,1442673,-1069
418,2021-05-18,São Paulo,4721,1109918,0,32394,1021700,55824,42737,2772124,4578,1447251,632
419,2021-05-19,São Paulo,4555,1114473,158,32552,1021683,60238,52269,2824393,4030,1451281,4414
420,2021-05-20,São Paulo,4853,1119326,97,32649,1023945,62732,53503,2877896,4596,1455877,2494
421,2021-05-21,São Paulo,4483,1123809,90,32739,1028573,62497,81852,2959748,5481,1461358,-235
422,2021-05-22,São Paulo,4349,1128158,98,32837,1032956,62365,45126,3004874,7520,1468878,-132
423,2021-05-23,São Paulo,0,1128158,55,32892,1037028,58238,5677,3010551,2647,1471525,-4127
424,2021-05-24,São Paulo,2752,1130910,168,33060,1041142,56708,25924,3036475,12981,1484506,-1530
425,2021-05-25,São Paulo,4946,1135856,29,33089,1044419,58348,53504,3089979,15544,1500050,1640
426,2021-05-26,São Paulo,5010,1140866,82,33171,1044384,63311,48776,3138755,15091,1515141,4963
427,2021-05-27,São Paulo,2239,1143105,127,33298,1047112,62695,43162,3181917,15303,1530444,-616
428,2021-05-28,São Paulo,469,1143574,204,33502,1052274,57798,61670,3243587,12526,1542970,-4897
429,2021-05-29,São Paulo,0,1143574,4,33506,1056996,53072,68942,3312529,9731,1552701,-4726
430,2021-05-30,São Paulo,0,1143574,4,33510,1060753,49311,24968,3337497,3252,1555953,-3761
431,2021-05-31,São Paulo,12908,1156482,38,33548,1065364,57570,23578,3361075,6234,1562187,8259
432,2021-06-01,São Paulo,5298,1161780,0,33548,1069371,58861,46572,3407647,17098,1579285,1291
433,2021-06-02,São Paulo,5363,1167143,126,33674,1069261,64208,60755,3468402,14360,1593645,5347
434,2021-06-03,São Paulo,4848,1171991,225,33899,1072803,65289,67340,3535742,15433,1609078,1081
435,2021-06-04,São Paulo,4386,1176377,263,34162,1077524,64691,50242,3585984,13228,1622306,-598
436,2021-06-05,São Paulo,4077,1180454,85,34247,1081921,64286,49764,3635748,17087,1639393,-405
437,2021-06-06,São Paulo,0,1180454,19,34266,1086677,59511,16279,3652027,5307,1644700,-4775
438,2021-06-07,São Paulo,4335,1184789,74,34340,1091070,59379,25250,3677277,4741,1649441,-132
439,2021-06-08,São Paulo,4703,1189492,56,34396,1095321,59775,49959,3727236,6704,1656145,396
440,2021-06-09,São Paulo,4255,1193747,141,34537,1095266,63944,45800,3773036,5110,1661255,4169
441,2021-06-10,São Paulo,6091,1199838,301,34838,1097850,67150,44059,3817095,4335,1665590,3206
442,2021-06-11,São Paulo,5074,1204912,93,34931,1102767,67214,61470,3878565,3610,1669200,64
443,2021-06-12,São Paulo,4946,1209858,16,34947,1107695,67216,47752,3926317,2042,1671242,2
444,2021-06-13,São Paulo,0,1209858,33,34980,1109807,65071,9720,3936037,435,1671677,-2145
445,2021-06-14,São Paulo,2767,1212625,59,35039,1110072,67514,38236,3974273,2135,1673812,2443
446,2021-06-15,São Paulo,5820,1218445,67,35106,1110068,73271,68139,4042412,4006,1677818,5757
447,2021-06-16,São Paulo,5263,1223708,107,35213,1110064,78431,90693,4133105,3494,1681312,5160
448,2021-06-17,São Paulo,5240,1228948,221,35434,1122934,70580,119969,4253074,3190,1684502,-7851
449,2021-06-18,São Paulo,8528,1237476,116,35550,1128232,73694,117513,4370587,3200,1687702,3114
450,2021-06-19,São Paulo,924,1238400,37,35587,1133469,69344,136768,4507355,2630,1690332,-4350
451,2021-06-20,São Paulo,0,1238400,19,35606,1138092,64702,66333,4573688,993,1691325,-4642
452,2021-06-21,São Paulo,6881,1245281,98,35704,1142215,67362,40649,4614337,1036,1692361,2660
453,2021-06-22,São Paulo,5418,1250699,22,35726,1146207,68766,47350,4661687,2316,1694677,1404
454,2021-06-23,São Paulo,5281,1255980,29,35755,1146188,74037,70772,4732459,3603,1698280,5271
455,2021-06-24,São Paulo,3928,1259908,151,35906,1150449,73553,94146,4826605,4659,1702939,-484
456,2021-06-25,São Paulo,4243,1264151,131,36037,1155096,73018,106896,4933501,2645,1705584,-535
